"","Q49.1","Q49.2","Q49.3","Q49.4","Q49.5","Q49.6","valence","manipulation_check1","manipulation_check2","pre_willing_buy","pre_pleasant","pre_market_value","pre_impressed","sensitivity","manipulation","direction","post_willing_buy","post_pleasant","post_market_value","post_impressed","change_willing_buy","change_pleasant","change_market_value","change_impressed","change_extension_DV"
"1",75,2,"Tellus ante ultrices sagittis bibendum luctus etiam temporibus ab posuere volutpat ut.","Laoreet temporibus wisi. Turpis! Odio egestas magnis. Natoque nullam mi ridiculus. Culpa.",6,7,"positive",21,21,4,4,8,9,3,"Contagion","Highlighted",7,1,6,3,3,-3,-2,-6,-4
"2",85,2,"Metus convallis sem pellentesque laoreet! Ultrices commodo sapien magnis felis rutrum gravida.","Vel duis sit placerat! Elementum luctus accumsan, auctor orci cursus blandit. Porttitor placerat! Id.",5,3,"positive",21,21,2,9,2,6,6.66666666666667,"Contagion","Highlighted",9,9,2,5,7,0,0,-1,-0.5
"3",10,2,"Metus accumsan, justo urna. Consectetuer vivamus tortor montes. Phasellus orci vel.","Elit natoque suspendisse porttitor nunc sapien ligula? Nec ipsum duis mauris facilisis diam.",3,7,"positive",22,22,7,8,6,7,5.66666666666667,"Contagion","Highlighted",7,3,8,2,0,-5,2,-5,-1.5
"4",50,1,"Ipsum in et. Gravida ante malesuada aliquam sapien mattis phasellus ante primis dui orci.","Vivamus montes malesuada purus porttitor ac turpis pede? Primis tempora dictumst auctor facilisis sapien.",3,2,"positive",21,21,8,3,1,8,7,"Contagion","Highlighted",9,8,5,1,1,5,4,-7,-1.5
"5",53,1,"Nullam gravida dignissim cursus diam maecenas. Nunc tellus vitae platea fusce.","Nec nec est curabitur erat aenean est commodo vitae quis porttitor metus? Convallis curabitur.",4,4,"positive",21,22,8,6,2,6,4.33333333333333,"Contagion","Highlighted",6,5,2,9,-2,-1,0,3,1.5
"6",73,4,"Quis. Laoreet! Est. Vestibulum sapien urna dui. Duis justo ab? In.","Platea. Nunc proin elementum! Praesent donec pellentesque per culpa risus facilisi gravida.",4,6,"positive",22,22,4,3,7,4,5,"Contagion","Highlighted",7,4,1,1,3,1,-6,-3,-4.5
"7",44,2,"Urna blandit urna aliquet ultricies odio, lorem. Ut diam ultrices purus.","Pellentesque eget. Tincidunt tempora nec pellentesque vehicula aliquet eu gravida culpa? Nullam sem? Sem.",3,4,"positive",21,22,1,5,3,9,3,"Contagion","Highlighted",5,1,2,6,4,-4,-1,-3,-2
"8",49,1,"Tempor, eleifend. Luctus quis. Morbi! Ut fringilla tempor sem sit. Amet sagittis posuere ipsum.","Vehicula sem facilisis consequat est temporibus facilisi natoque porta tempor.",1,3,"positive",21,22,5,8,5,2,5.33333333333333,"Contagion","Highlighted",5,6,6,8,0,-2,1,6,3.5
"9",76,3,"Laoreet justo, velit. Sed natoque. Lacus ultricies. Quam dapibus! Gravida.","Suspendisse ab aliquam quis! Etiam volutpat rutrum consequat platea volutpat morbi arcu luctus maecenas.",5,5,"positive",21,21,6,2,6,1,6,"Contagion","Highlighted",5,5,7,1,-1,3,1,0,0.5
"10",96,1,"A vestibulum phasellus urna fringilla nibh lorem lectus sollicitudin culpa porta, duis dapibus.","Bibendum! Maecenas porta etiam sodales odio, wisi duis viverra augue, suscipit leo! Montes facilisis magna.",2,1,"positive",21,22,4,2,3,7,5,"Contagion","Highlighted",6,7,7,3,2,5,4,-4,0
"11",28,3,"Fusce lectus tortor phasellus curabitur! Tempora facilisis culpa enim, potenti facilisi consequat. Eros neque eu.","Sed justo enim aliquet sapien tempora temporibus nunc dolor lacus.",5,1,"positive",22,22,7,7,4,3,4,"Contagion","Highlighted",2,8,2,5,-5,1,-2,2,0
"12",41,3,"Convallis tempor. Sapien quis! Cras ultricies integer sit malesuada leo nibh.","Eget suspendisse platea? Tincidunt malesuada gravida atque non etiam vulputate culpa malesuada ligula.",2,1,"positive",22,22,7,7,2,4,3.66666666666667,"Contagion","Highlighted",4,2,8,7,-3,-5,6,3,4.5
"13",87,2,"Phasellus lorem leo odio accusamus felis pretium facilisis mi nec malesuada praesent iaculis metus.","Commodo venenatis? Proin primis pretium auctor augue mi vitae! Accumsan venenatis orci.",4,1,"positive",22,22,9,2,8,8,5.33333333333333,"Contagion","Highlighted",5,7,7,6,-4,5,-1,-2,-1.5
"14",53,4,"Fermentum lacus eros laoreet egestas! Lacus, atque felis ligula. Metus diam fringilla, accumsan! Temporibus.","Platea cras. Volutpat dui temporibus augue. Lacus etiam nonummy felis wisi faucibus mi. Sapien phasellus.",1,3,"positive",21,21,5,7,1,2,4.33333333333333,"Contagion","Highlighted",8,8,7,3,3,1,6,1,3.5
"15",82,3,"Elit dapibus, cras euismod, dui! Elementum! Rhoncus pretium tincidunt eget ultrices.","Dolorem? Duis! Amet lacus montes orci vulputate neque bibendum turpis turpis convallis turpis aliquet.",6,6,"positive",22,21,2,8,3,1,5,"Contagion","Highlighted",6,7,4,8,4,-1,1,7,4
"16",41,2,"Volutpat? Praesent nulla? Vel aenean accumsan donec commodo sapien mauris diam.","Blandit purus pellentesque volutpat pellentesque. Felis. Vivamus. Dui mattis aenean felis volutpat, odio.",1,4,"positive",21,22,4,8,7,7,3.66666666666667,"Contagion","Highlighted",2,3,9,4,-2,-5,2,-3,-0.5
"17",99,4,"Dignissim? Pretium! Enim? In vulputate lorem! Sapien risus suscipit proin mi? Ante maecenas.","Turpis? Interdum molestie maecenas malesuada ante! Scelerisque duis elit. Nullam.",6,1,"positive",21,22,3,4,5,9,4,"Contagion","Highlighted",2,1,6,1,-1,-3,1,-8,-3.5
"18",63,2,"Felis ac! Massa odio egestas? Vehicula odio tellus eget in dictumst odio.","Vitae scelerisque. A risus quam. Est ut dignissim felis dictumst nullam mattis curabitur tortor.",1,6,"positive",22,21,6,9,1,1,7,"Contagion","Highlighted",1,2,9,4,-5,-7,8,3,5.5
"19",9,2,"Vitae maecenas tincidunt. Erat vehicula. Aenean non elit fermentum aliquam vehicula maecenas iaculis! Integer! Ultrices.","Praesent, ullamcorper? Rutrum velit. Facilisis et wisi sit ab iaculis sem.",5,2,"positive",21,22,7,5,2,9,3.66666666666667,"Contagion","Highlighted",1,5,8,3,-6,0,6,-6,0
"20",62,3,"Fusce facilisis dolorem accusamus dui enim aenean cras. Ipsum aliquam.","Primis atque? Scelerisque eget mauris maecenas! Massa dolor. Ante est pede temporibus.",3,7,"positive",21,22,4,4,9,1,6,"Contagion","Highlighted",3,7,5,9,-1,3,-4,8,2
"21",46,1,"Quis est. Diam, gravida! Nonummy convallis ridiculus dolor? Metus pede cursus venenatis. Natoque.","Ullamcorper. Aenean interdum ac nulla cursus molestie mi cras quis? Consectetuer ridiculus est ab.",2,6,"positive",22,22,9,4,1,6,5.66666666666667,"Contagion","Highlighted",6,4,8,5,-3,0,7,-1,3
"22",76,2,"Donec ligula mauris vel, ullamcorper elit volutpat venenatis. At dolor.","Atque dignissim. Montes per malesuada quis! Temporibus metus accumsan ultricies.",5,7,"positive",22,22,6,8,1,6,3.66666666666667,"Contagion","Highlighted",2,9,5,8,-4,1,4,2,3
"23",3,1,"Porttitor? Sollicitudin suscipit? Iaculis curabitur luctus? Dolor enim ab aliquam et elementum quis? Nullam. Nonummy.","Ipsum fusce risus curabitur dignissim elit, neque maecenas rutrum. Id eros ac.",1,2,"positive",22,22,3,2,4,4,4,"Contagion","Highlighted",5,9,5,5,2,7,1,1,1
"24",84,3,"Per rhoncus vivamus volutpat urna sem orci? Praesent quam ultrices magna! Nulla erat.","Mauris! Commodo. Augue? Montes bibendum iaculis tellus faucibus atque rutrum fusce.",2,6,"positive",21,22,6,7,7,5,4.66666666666667,"Contagion","Highlighted",2,7,1,3,-4,0,-6,-2,-4
"25",82,1,"Venenatis consequat pede. Dolorem vivamus tempus? Donec dapibus urna egestas eget pharetra quam.","A lacus. Cursus interdum ultricies sodales per. Donec duis enim? Atque odio tortor.",6,3,"positive",21,22,4,8,1,9,4.33333333333333,"Contagion","Highlighted",5,3,8,1,1,-5,7,-8,-0.5
"26",40,3,"Facilisis euismod! Gravida. Sit. Phasellus natoque per volutpat ab duis.","Iaculis ut primis, vulputate rhoncus porta accumsan? Maecenas pellentesque sem.",3,4,"positive",22,22,1,9,5,6,6.33333333333333,"Contagion","Highlighted",4,9,6,3,3,0,1,-3,-1
"27",56,1,"Dolor suscipit nunc. Vitae ultricies, nonummy montes mi scelerisque pretium.","Mi ultricies fermentum, accumsan nec neque curabitur atque enim luctus, felis mi ridiculus mauris.",5,3,"positive",22,22,4,1,5,2,3.66666666666667,"Contagion","Highlighted",6,1,8,3,2,0,3,1,2
"28",70,3,"Et augue diam vulputate faucibus integer tempor accusamus accumsan elementum dolor.","Integer luctus imperdiet wisi. Orci dui morbi sed lorem donec culpa iaculis.",1,3,"positive",21,21,3,2,6,8,5,"Contagion","Highlighted",9,3,6,8,6,1,0,0,0
"29",31,1,"Turpis praesent. Non enim sem purus pharetra posuere mi vehicula? Suspendisse.","Velit lorem convallis dui? Sed euismod nullam, augue, neque rhoncus.",4,3,"positive",22,22,8,8,2,4,3.66666666666667,"Contagion","Highlighted",1,7,8,1,-7,-1,6,-3,1.5
"30",30,3,"Rutrum facilisi atque euismod mi maecenas lacus elementum risus sem.","Nec porta nunc felis, et blandit volutpat? Amet nec! Erat dictumst facilisis ullamcorper facilisi.",3,7,"positive",22,22,3,1,5,2,5.33333333333333,"Contagion","Highlighted",1,2,5,8,-2,1,0,6,3
"31",79,1,"Consectetuer urna luctus quis wisi integer aliquam? Wisi per dui orci.","Felis. Integer morbi augue? Commodo eleifend sed tempus consequat dolorem scelerisque, pede tempor.",5,5,"positive",22,21,9,7,1,5,5.33333333333333,"Contagion","Highlighted",3,5,6,4,-6,-2,5,-1,2
"32",99,2,"Mauris proin ab magna montes ac nonummy diam morbi vulputate venenatis.","Ac. Vulputate pede eleifend suspendisse. Elementum etiam donec proin at ante leo a! Viverra vulputate.",4,3,"positive",22,22,3,2,8,4,5.66666666666667,"Contagion","Highlighted",1,1,3,7,-2,-1,-5,3,-1
"33",44,4,"Nec facilisi massa orci. Euismod integer wisi? Et. Orci bibendum imperdiet. Quis diam molestie.","Urna facilisi ultrices leo. Maecenas cras sagittis. Accusamus suscipit. Laoreet pede.",4,6,"positive",22,21,2,9,1,7,4,"Contagion","Highlighted",3,6,5,5,1,-3,4,-2,1
"34",68,4,"Eleifend vulputate, commodo dui enim ridiculus consequat? Amet! Lacus venenatis, suspendisse? Ullamcorper pellentesque facilisi.","Phasellus laoreet. Tincidunt eros faucibus quis. Bibendum facilisi dui et faucibus.",1,4,"positive",21,21,8,4,8,5,4.66666666666667,"Contagion","Highlighted",1,6,6,3,-7,2,-2,-2,-2
"35",24,3,"Tempus quis vehicula culpa sapien venenatis imperdiet. Vulputate eros lectus! Egestas.","Vulputate fusce donec malesuada, et phasellus amet leo tellus sollicitudin tincidunt magna, velit? Quis.",1,5,"positive",22,22,4,6,5,2,2.66666666666667,"Contagion","Highlighted",5,6,3,7,1,0,-2,5,1.5
"36",100,2,"Proin ultricies sed? Vestibulum integer dolorem wisi! Aliquam mi sodales.","Eget montes platea curabitur. Culpa est tempor phasellus tortor, montes.",4,6,"positive",22,21,9,8,2,2,6,"Contagion","Highlighted",8,9,6,8,-1,1,4,6,5
"37",60,2,"Imperdiet. Curabitur est imperdiet integer, rutrum? Elementum natoque montes donec accumsan. Malesuada commodo nulla? Rutrum.","Proin? Vestibulum. Fringilla etiam potenti fringilla urna. Cursus ultricies eu.",5,7,"positive",21,21,6,8,5,1,8.33333333333333,"Contagion","Highlighted",1,6,4,3,-5,-2,-1,2,0.5
"38",21,1,"Ab fringilla tempor posuere! Temporibus elementum quis gravida sit. Nonummy. Montes, rhoncus metus? Tincidunt.","Cursus placerat nibh dolor? At consequat tellus cursus ab egestas.",4,1,"positive",22,21,4,6,8,1,3.33333333333333,"Contagion","Highlighted",3,3,5,7,-1,-3,-3,6,1.5
"39",55,1,"Arcu tempus faucibus faucibus vulputate velit. Gravida eros integer aliquam.","Porta venenatis. Faucibus? Phasellus. Fusce pretium. Eleifend eleifend lectus dolor.",4,6,"positive",21,21,5,8,9,9,4.33333333333333,"Contagion","Highlighted",1,5,5,6,-4,-3,-4,-3,-3.5
"40",54,1,"Facilisis? Integer atque. Dapibus sem non sem donec. Dapibus pharetra.","Ac, rhoncus venenatis consectetuer suspendisse, pede morbi ut montes montes leo. Justo fermentum! Sit.",1,1,"positive",22,21,4,6,2,8,4,"Contagion","Highlighted",8,5,8,7,4,-1,6,-1,2.5
"41",84,3,"Vehicula ligula pellentesque faucibus quam. Ante purus sed tortor sagittis euismod. Curabitur, donec posuere.","Pellentesque suspendisse facilisis consectetuer etiam suspendisse amet, fusce non. Metus.",2,3,"positive",22,22,6,3,6,9,2,"Contagion","Highlighted",4,7,4,5,-2,4,-2,-4,-3
"42",79,2,"Tortor. Montes viverra. Dapibus fringilla. Augue mattis eu interdum aenean.","Eget orci ut est dolor nec? Nonummy consequat dolor. Amet rhoncus, eleifend faucibus.",3,1,"positive",21,22,6,4,8,1,6.33333333333333,"Contagion","Highlighted",1,5,8,9,-5,1,0,8,4
"43",2,4,"Culpa tortor pede odio magnis malesuada ligula praesent rutrum! Accumsan sagittis.","Praesent facilisis arcu mattis natoque laoreet. Proin aenean tempora eleifend praesent urna.",1,3,"positive",21,21,9,2,8,5,4.66666666666667,"Contagion","Highlighted",3,9,2,6,-6,7,-6,1,-2.5
"44",24,2,"Mi! Bibendum dolor, tempor? Magnis mattis ante placerat facilisi morbi consectetuer.","Accumsan donec aenean vitae. Maecenas! Velit facilisis eget mattis tellus fusce fermentum nonummy dolor.",6,2,"positive",22,21,4,1,4,9,4.33333333333333,"Contagion","Highlighted",9,5,6,9,5,4,2,0,1
"45",57,3,"Tortor amet wisi mattis platea placerat ultricies dignissim bibendum nulla, viverra sagittis.","Etiam auctor cursus arcu etiam eleifend. Fusce posuere pellentesque. Proin mattis! Wisi placerat.",6,7,"positive",22,22,4,7,1,6,4,"Contagion","Highlighted",7,7,8,2,3,0,7,-4,1.5
"46",89,1,"Eu? Et nec elementum, a tellus. Ultricies molestie interdum! Viverra.","Risus culpa natoque fusce dolorem sollicitudin pellentesque turpis auctor id aliquet.",4,2,"positive",21,21,5,1,9,8,5.66666666666667,"Contagion","Highlighted",6,5,1,8,1,4,-8,0,-4
"47",81,1,"Facilisis sagittis pede pellentesque lorem elementum amet vehicula sodales integer.","Ultrices aliquet primis quis vulputate? A fusce faucibus ac tempus ligula, justo, proin viverra.",6,3,"positive",21,22,9,5,8,9,4.66666666666667,"Contagion","Highlighted",9,9,1,4,0,4,-7,-5,-6
"48",29,1,"Enim auctor bibendum fringilla! Dapibus sem! Potenti eget dolorem euismod facilisi. Facilisis.","Duis diam magnis augue iaculis. Primis arcu, euismod montes primis.",6,3,"positive",22,22,4,1,1,8,6.33333333333333,"Contagion","Highlighted",6,7,9,2,2,6,8,-6,1
"49",43,2,"Temporibus? Lacus justo massa. Volutpat pharetra amet dignissim phasellus integer.","Ut, amet porttitor sagittis tempus et, vulputate, justo convallis amet. Quis justo scelerisque sed? Nonummy.",1,4,"positive",21,22,5,2,2,7,2.33333333333333,"Contagion","Highlighted",3,2,1,2,-2,0,-1,-5,-3
"50",20,4,"Arcu augue per tortor lacus diam bibendum, tempus gravida porta convallis? Laoreet! Nullam.","Accumsan metus sollicitudin etiam suscipit mauris atque ipsum porta quis. Bibendum pretium. Placerat.",4,1,"positive",21,22,9,4,9,1,5.33333333333333,"Contagion","Highlighted",2,3,8,4,-7,-1,-1,3,1
"51",23,3,"Id luctus a sit. Lectus consectetuer. Erat volutpat suscipit convallis auctor? Ante atque nonummy ultrices.","Nibh tempus montes ligula ullamcorper! Amet proin? Lacus neque? Egestas.",1,1,"positive",22,21,4,9,3,3,4,"Contagion","Highlighted",7,8,3,6,3,-1,0,3,1.5
"52",3,1,"Sollicitudin vulputate accusamus sagittis! Cursus leo ipsum lacus? Potenti venenatis primis diam quam.","Nec! Accusamus integer ullamcorper lacus tellus molestie commodo praesent at.",6,3,"positive",21,21,1,8,9,3,6.66666666666667,"Contagion","Highlighted",9,5,9,8,8,-3,0,5,2.5
"53",59,2,"Id ligula a cursus, integer tempus sit cras? Sit turpis ab amet dignissim.","Rhoncus fringilla metus consequat, maecenas nunc ullamcorper interdum egestas nibh porttitor.",4,6,"positive",21,22,9,6,5,6,1.33333333333333,"Contagion","Highlighted",7,6,6,9,-2,0,1,3,2
"54",8,2,"Vitae dictumst lectus ab integer. Cras dictumst nullam. Mi proin platea curabitur vehicula.","Dictumst erat! Dictumst purus temporibus pretium duis ligula pellentesque tempor.",1,6,"positive",21,21,6,7,5,8,5,"Contagion","Highlighted",1,9,1,5,-5,2,-4,-3,-3.5
"55",2,4,"Molestie pretium. Venenatis vel. Vulputate porta porta ultricies amet id neque potenti dictumst felis! Primis.","Fringilla tellus felis imperdiet donec est. Arcu. Curabitur vulputate vehicula. Risus donec tempus cras velit.",1,7,"positive",21,22,6,4,1,5,3,"Contagion","Highlighted",9,6,1,1,3,2,0,-4,-2
"56",68,1,"Cursus ipsum praesent? Integer velit blandit? Laoreet. Sapien ligula facilisis porttitor ipsum culpa venenatis.","Sit tellus dui tempus faucibus maecenas pede? Viverra aliquam imperdiet nunc ultricies interdum magnis.",2,1,"positive",22,22,4,7,9,4,4.66666666666667,"Contagion","Highlighted",6,4,2,4,2,-3,-7,0,-3.5
"57",11,2,"Phasellus est facilisi convallis diam pretium suspendisse sit natoque et tempus.","Montes, rhoncus! Sagittis. Natoque eleifend augue sodales rhoncus arcu volutpat volutpat sit. Dolorem justo.",1,7,"positive",22,22,3,3,9,6,5,"Contagion","Highlighted",9,6,6,4,6,3,-3,-2,-2.5
"58",49,4,"Bibendum pede mi egestas posuere dictumst? Iaculis. Rhoncus vulputate nunc imperdiet nulla.","Euismod vestibulum. Eget ut curabitur justo magnis dictumst maecenas? Vehicula.",3,2,"positive",22,21,2,2,9,3,7.33333333333333,"Contagion","Highlighted",3,5,6,7,1,3,-3,4,0.5
"59",98,2,"Tempora cras. Lorem neque, ut. Aliquet, ipsum pretium. Viverra vestibulum per montes.","Leo curabitur eu quam accumsan. Pretium iaculis rhoncus, molestie? Cursus est? Velit.",5,2,"positive",21,22,5,5,9,5,5,"Contagion","Highlighted",6,3,1,7,1,-2,-8,2,-3
"60",20,1,"Cursus porta bibendum arcu. Eget consequat vulputate laoreet natoque! Facilisi suspendisse! Phasellus.","Pede felis vulputate nunc integer morbi pretium viverra tellus posuere, eleifend ante. Platea arcu! Magnis.",6,4,"positive",21,22,9,6,2,6,4,"Contagion","Highlighted",3,5,8,3,-6,-1,6,-3,1.5
"61",92,2,"Justo turpis fermentum enim sem mattis temporibus ut vehicula felis sollicitudin nonummy.","Molestie sed, phasellus nulla praesent dictumst cursus. Enim gravida. Dolor. Maecenas leo luctus nulla.",5,2,"positive",21,21,7,2,4,2,7,"Contagion","Highlighted",9,2,3,6,2,0,-1,4,1.5
"62",21,1,"Nulla sem! Ipsum mi vestibulum tempus lacus, facilisis, duis ultricies gravida praesent dictumst.","At, quam eros! Nulla placerat leo phasellus elementum consequat dapibus.",3,2,"positive",22,22,3,6,9,3,3.66666666666667,"Contagion","Highlighted",6,7,7,6,3,1,-2,3,0.5
"63",7,2,"Suscipit sodales eu eleifend molestie sagittis pede temporibus! Turpis. Auctor.","Lorem massa venenatis luctus vivamus volutpat blandit non ridiculus ridiculus augue tempus molestie blandit.",5,6,"positive",21,22,6,9,5,2,4,"Contagion","Highlighted",6,8,1,4,0,-1,-4,2,-1
"64",94,2,"Posuere et eu euismod. Per volutpat porta duis? Maecenas porttitor ut eget.","Donec porta. Pellentesque pharetra praesent mauris odio fusce interdum potenti vel.",2,6,"positive",22,22,4,5,4,9,5.66666666666667,"Contagion","Highlighted",6,5,6,5,2,0,2,-4,-1
"65",74,3,"Porta molestie eu! Fusce tincidunt potenti praesent turpis potenti id sed. Aenean integer accusamus ullamcorper.","Eleifend morbi, interdum nonummy. Porttitor cursus est vitae facilisi arcu pretium donec? Augue.",5,1,"positive",22,22,3,1,9,5,7,"Contagion","Highlighted",6,1,8,1,3,0,-1,-4,-2.5
"66",28,1,"Est. Suspendisse pellentesque! Nec turpis? Diam vehicula enim! Donec pede mi a ridiculus.","Curabitur lectus imperdiet iaculis culpa praesent nonummy aenean. Vestibulum lorem! Magnis sodales accusamus cursus.",5,2,"positive",22,22,8,6,8,3,4.66666666666667,"Contagion","Highlighted",3,6,3,8,-5,0,-5,5,0
"67",73,3,"Interdum ut non curabitur ante ullamcorper. Euismod molestie viverra tempor! Nulla lectus maecenas.","Convallis diam elit aenean mauris placerat ac! Pharetra temporibus facilisi. Vestibulum.",1,5,"positive",22,21,8,1,3,4,3.66666666666667,"Contagion","Highlighted",4,7,2,8,-4,6,-1,4,1.5
"68",36,4,"Ultricies augue! Fringilla odio, aliquam mauris ut porttitor porttitor etiam. Nullam.","Sodales! Dui dolorem luctus per duis sem nullam duis, auctor posuere ac.",3,4,"positive",22,22,6,7,7,3,5,"Contagion","Highlighted",3,5,4,6,-3,-2,-3,3,0
"69",60,4,"Magnis sodales leo culpa ligula proin. Tortor id. Interdum! Est gravida.","Nonummy justo! Tempor fusce lorem curabitur? Eu aliquet dolorem vestibulum accumsan accumsan.",4,3,"positive",22,22,5,2,7,9,3.33333333333333,"Contagion","Highlighted",5,6,6,7,0,4,-1,-2,-1.5
"70",14,3,"Sollicitudin per, accusamus neque tempora fusce, auctor lectus venenatis suscipit donec vel at arcu augue.","Donec ab nibh lectus ultrices sagittis velit tempor? Platea accumsan enim.",1,7,"positive",22,21,8,9,6,9,4.33333333333333,"Contagion","Highlighted",1,3,8,4,-7,-6,2,-5,-1.5
"71",80,3,"Porttitor fusce, dignissim porttitor luctus pharetra lorem. Aenean tortor enim ab tempor.","Etiam consectetuer wisi elementum elit tincidunt integer rhoncus eget sed? Malesuada justo. Nullam eu.",6,7,"positive",22,22,3,7,2,4,6,"Contagion","Highlighted",2,8,6,3,-1,1,4,-1,1.5
"72",55,4,"Tellus a elit duis venenatis! Blandit suscipit? Quam vitae ac sem fringilla ridiculus.","Molestie mattis platea mauris ultricies platea! Et accusamus, sapien. Luctus amet. Vel massa volutpat. Lectus.",5,7,"positive",21,21,5,7,7,1,5,"Contagion","Highlighted",2,5,8,6,-3,-2,1,5,3
"73",81,3,"Elementum consectetuer! Volutpat lorem risus vitae laoreet felis id mi.","Morbi malesuada praesent eu tempor cursus. Wisi consequat tempora. Sed vehicula? Erat rhoncus ipsum atque.",2,4,"positive",21,21,7,1,3,3,4.66666666666667,"Contagion","Highlighted",8,9,7,6,1,8,4,3,3.5
"74",49,4,"Curabitur augue vivamus consequat. Eu eget vel felis est ab. Phasellus. Aenean faucibus.","Eget est placerat felis. Magnis faucibus sagittis tellus ipsum justo ut. Proin? Eleifend platea.",6,6,"positive",22,22,8,4,4,7,5.33333333333333,"Contagion","Highlighted",2,9,5,5,-6,5,1,-2,-0.5
"75",49,1,"Suscipit et iaculis dignissim lorem aliquet donec lorem, bibendum! Magnis primis tempora ab.","Nec lorem tincidunt elit molestie ultrices imperdiet praesent at consequat accumsan? Mattis auctor.",1,2,"positive",21,21,2,6,8,6,7,"Contagion","Highlighted",2,7,4,6,0,1,-4,0,-2
"76",9,1,"Sagittis cursus? Interdum. Risus. Dolorem. At neque lectus aenean curabitur sodales.","Laoreet quam proin auctor? Et praesent molestie. Odio accusamus porttitor ligula ut.",5,2,"positive",22,22,2,2,4,2,5.33333333333333,"Contagion","Highlighted",2,9,9,5,0,7,5,3,4
"77",42,2,"Sollicitudin massa. Velit! Aenean pretium! Ante rhoncus magnis porttitor platea amet nibh? Elit lorem viverra.","Atque mauris odio? Porttitor convallis ante platea erat aliquet luctus quis. Morbi elit.",4,7,"positive",22,21,3,1,8,4,5.33333333333333,"Contagion","Highlighted",4,8,3,7,1,7,-5,3,-1
"78",45,2,"Eget interdum? Dapibus id! Justo? Ac rutrum in nunc suscipit! Pretium.","Dictumst proin gravida orci temporibus luctus imperdiet porttitor eu convallis fermentum leo ridiculus venenatis.",5,1,"positive",21,22,1,1,4,3,6.66666666666667,"Contagion","Highlighted",9,9,9,6,8,8,5,3,4
"79",48,3,"Egestas! Sed. Nunc fermentum. Consequat luctus quis gravida, odio interdum ultrices metus iaculis.","Luctus suspendisse dignissim ante curabitur leo arcu ullamcorper posuere! Tortor.",5,4,"positive",21,22,8,7,9,8,6,"Contagion","Highlighted",2,7,1,1,-6,0,-8,-7,-7.5
"80",22,2,"HK","HK",4,5,"positive",22,21,8,7,9,9,4.66666666666667,"Contagion","Highlighted",8,8,9,9,0,1,0,0,0
"81",88,2,"Placerat phasellus ridiculus potenti integer malesuada aliquam eleifend, suscipit vehicula justo mattis commodo.","Porta vehicula in malesuada dolor eget, lectus. Aliquet etiam. Curabitur.",3,3,"positive",22,21,4,4,1,9,4.33333333333333,"Contagion","Decreased",9,6,8,3,5,2,7,-6,0.5
"82",25,3,"Porta. Nunc vitae metus pharetra consectetuer a phasellus. Et rutrum suscipit donec.","Et egestas sem mauris! Non. Eu metus lacus ut praesent dapibus erat.",4,7,"positive",21,22,9,1,2,2,5.66666666666667,"Contagion","Decreased",5,8,4,1,-4,7,2,-1,0.5
"83",21,4,"In non elit tortor etiam posuere at ante. Erat, mattis ante. Arcu iaculis sem.","Tortor purus felis eros nec integer malesuada eu ab. Arcu at ullamcorper a convallis tempora.",1,3,"positive",21,21,5,7,4,7,6.33333333333333,"Contagion","Decreased",3,4,5,3,-2,-3,1,-4,-1.5
"84",85,3,"Scelerisque imperdiet tellus montes erat temporibus massa wisi ultricies. Sapien.","Et cras. Eros. Non! Tempora nunc interdum proin ac interdum sodales velit. Phasellus a.",5,6,"positive",22,21,1,1,6,6,7.66666666666667,"Contagion","Decreased",8,6,2,4,7,5,-4,-2,-3
"85",50,4,"Lorem! Phasellus facilisi quam molestie ultrices vivamus nulla nullam quam rhoncus? Molestie.","Aliquam phasellus id? Cursus commodo! Sem tortor, wisi? Tortor donec sollicitudin aenean. Vel.",6,7,"positive",22,21,6,6,3,8,4,"Contagion","Decreased",8,3,5,1,2,-3,2,-7,-2.5
"86",90,4,"Nunc porttitor luctus augue nibh pellentesque mauris aliquet erat, est facilisi est fringilla amet.","Sem tellus scelerisque nulla. Gravida. Consectetuer neque a quam tempor elit tempus.",5,2,"positive",21,22,8,5,8,2,5.66666666666667,"Contagion","Decreased",3,5,4,8,-5,0,-4,6,1
"87",5,3,"Cras elit? Amet nulla. Eros risus non eu cursus suscipit.","Ut tempora cras! Tempus posuere est nibh felis dolorem augue eget.",5,4,"positive",22,21,5,8,1,5,5,"Contagion","Decreased",2,6,3,8,-3,-2,2,3,2.5
"88",86,2,"Id phasellus rhoncus porta. Ipsum suspendisse sit. Elit auctor facilisi, quam. Mattis? Sem dictumst tempora.","Venenatis mattis accusamus, pretium at etiam augue felis ullamcorper viverra malesuada? Sodales ipsum facilisi.",5,4,"positive",22,22,1,5,5,1,4.33333333333333,"Contagion","Decreased",3,1,5,1,2,-4,0,0,0
"89",43,4,"Lacus atque ante ullamcorper dictumst. Metus lacus ante ac. Nunc? Maecenas velit.","Tellus! Culpa posuere culpa! Volutpat commodo sem cursus? Vestibulum? Pellentesque elementum.",6,5,"positive",22,22,7,5,5,9,8,"Contagion","Decreased",1,6,4,6,-6,1,-1,-3,-2
"90",63,3,"Cras auctor etiam, consequat, at primis auctor? Sollicitudin felis odio scelerisque.","Turpis potenti! Sagittis viverra duis amet montes velit sit, gravida, lacus.",4,6,"positive",22,22,8,6,8,7,6.33333333333333,"Contagion","Decreased",1,4,4,5,-7,-2,-4,-2,-3
"91",60,3,"Ridiculus vestibulum tempora eros. Wisi sapien accumsan natoque. Elementum tincidunt consequat? Vel.","Magnis imperdiet? Mi. Faucibus non, malesuada nunc elementum fusce accumsan! Phasellus iaculis cursus.",3,7,"positive",22,21,6,7,7,9,7,"Contagion","Decreased",7,6,4,4,1,-1,-3,-5,-4
"92",77,4,"Turpis? Lectus? Elementum laoreet sem nec porta arcu? Primis commodo.","Ligula convallis lorem dapibus ab montes lorem ac. Tellus elit eget.",3,5,"positive",21,21,3,8,2,7,5,"Contagion","Decreased",9,3,7,1,6,-5,5,-6,-0.5
"93",94,2,"Donec venenatis elit, ipsum vel vestibulum fringilla dolorem sed pede velit. Per etiam justo.","Nibh. Vestibulum iaculis sit ac duis temporibus duis accumsan diam ultrices accusamus blandit viverra.",5,2,"positive",21,22,4,3,9,3,6.33333333333333,"Contagion","Decreased",3,8,4,3,-1,5,-5,0,-2.5
"94",87,2,"Dolorem tellus posuere sed etiam orci posuere. Posuere mi id neque? Nec justo interdum.","Aliquet aliquet mauris. Nibh lacus vivamus. Tellus, mattis? Porttitor, curabitur platea eu suscipit! Wisi leo.",2,2,"positive",21,22,5,8,9,7,2,"Contagion","Decreased",2,7,2,1,-3,-1,-7,-6,-6.5
"95",89,1,"Nulla montes. Tempor volutpat! Ultrices eleifend a sagittis scelerisque dolor elementum ultrices dapibus.","Eget suspendisse ante temporibus enim phasellus! Diam, auctor. Potenti phasellus.",6,5,"positive",21,21,6,5,3,3,4.66666666666667,"Contagion","Decreased",2,2,8,8,-4,-3,5,5,5
"96",78,1,"Nonummy suscipit, etiam rutrum nulla per dolorem nunc diam! Commodo eleifend viverra.","Laoreet mi faucibus. Facilisi. Maecenas? Lorem blandit nunc! Sodales ut ultricies vivamus ligula.",6,4,"positive",21,21,6,5,1,6,7.66666666666667,"Contagion","Decreased",6,3,6,2,0,-2,5,-4,0.5
"97",96,1,"Imperdiet curabitur cursus sem ligula viverra metus vivamus. Ut elit volutpat. Diam potenti eleifend mi.","Diam volutpat. Mattis? Et? Donec placerat posuere porttitor dui ridiculus tempora. Mi.",2,4,"positive",21,22,5,7,8,5,7.33333333333333,"Contagion","Decreased",2,8,4,4,-3,1,-4,-1,-2.5
"98",74,2,"Phasellus! Per vel cras temporibus purus diam odio natoque vulputate nibh phasellus porta eu.","Magnis culpa quis egestas ac dignissim ligula pharetra lacus iaculis tortor id.",6,3,"positive",21,21,4,1,9,7,2,"Contagion","Decreased",6,4,2,4,2,3,-7,-3,-5
"99",78,4,"Diam enim at proin primis a risus lectus culpa. Atque, tortor vivamus montes dignissim.","Sed! Enim sollicitudin ultricies etiam. Et, dapibus viverra integer. Curabitur accumsan temporibus.",3,2,"positive",22,22,8,4,8,2,5.66666666666667,"Contagion","Decreased",3,9,1,1,-5,5,-7,-1,-4
"100",6,2,"Gravida curabitur cras vel aliquet? Dolor sapien! Atque. Proin commodo sagittis suspendisse risus magnis amet.","Quam nulla vitae ipsum? Scelerisque euismod eu. Porta? Cursus dolor.",6,7,"positive",22,21,7,2,4,3,7.66666666666667,"Contagion","Decreased",1,9,9,3,-6,7,5,0,2.5
"101",92,4,"Fermentum primis lorem porta facilisis sem vitae eget nulla. Venenatis magnis luctus primis.","Amet potenti? Vitae vitae fermentum ullamcorper. Accusamus fringilla ligula tortor tellus nunc rutrum malesuada.",2,3,"positive",22,22,9,5,5,9,5.33333333333333,"Contagion","Decreased",9,6,5,4,0,1,0,-5,-2.5
"102",50,3,"Dolorem molestie amet rutrum platea magna phasellus amet fusce dapibus! Consectetuer malesuada.","A venenatis purus, risus porttitor! Atque ultrices leo, gravida ante urna.",3,3,"positive",22,21,3,2,5,5,4.66666666666667,"Contagion","Decreased",2,1,5,4,-1,-1,0,-1,-0.5
"103",90,1,"Convallis ante egestas morbi vitae purus dictumst proin platea dui? Etiam.","Tempus urna, potenti sit eleifend? Curabitur iaculis! Tincidunt venenatis. Rhoncus ultricies felis amet natoque. Odio.",3,6,"positive",22,22,3,2,7,2,5.66666666666667,"Contagion","Decreased",9,2,4,9,6,0,-3,7,2
"104",41,1,"Proin posuere neque massa tempora placerat ligula nec mauris donec.","Cursus fringilla posuere tempor nullam vestibulum porttitor integer, platea enim tempor! Culpa mi vulputate.",4,4,"positive",21,21,2,3,6,1,2,"Contagion","Decreased",6,3,1,3,4,0,-5,2,-1.5
"105",82,1,"Lorem aliquet quis duis nulla elit sem consectetuer suspendisse ultrices in elit. Primis.","Laoreet integer metus mauris dapibus sagittis convallis est gravida! Accumsan, molestie nonummy duis arcu.",4,5,"positive",22,22,6,8,9,3,5.66666666666667,"Contagion","Decreased",2,8,1,2,-4,0,-8,-1,-4.5
"106",17,4,"Proin curabitur fermentum vitae! Commodo ultricies dictumst suscipit auctor aliquam culpa? Tempus lectus molestie ab.","Elit nullam accusamus turpis? Ut. Morbi vel urna vulputate, sit sit bibendum.",3,6,"positive",22,22,8,5,4,3,2.66666666666667,"Contagion","Decreased",6,7,4,8,-2,2,0,5,2.5
"107",51,4,"Rutrum, ligula consectetuer duis laoreet placerat risus magnis, sodales orci sed orci.","Magna velit ligula ridiculus vivamus, dictumst vel vel, egestas vulputate scelerisque nibh malesuada.",6,4,"positive",22,21,9,3,7,5,4,"Contagion","Decreased",6,3,9,4,-3,0,2,-1,0.5
"108",6,3,"Nonummy praesent pharetra magna nunc aenean at lacus! Platea. Viverra? Metus.","Sed molestie facilisis. Accusamus tempora euismod lectus sagittis blandit phasellus.",4,4,"positive",21,22,2,8,1,4,1.66666666666667,"Contagion","Decreased",3,1,8,6,1,-7,7,2,4.5
"109",0,3,"Scelerisque diam est? Iaculis cras interdum volutpat tempora! Eleifend duis imperdiet urna.","Duis risus at lacus. Ab malesuada urna curabitur leo urna etiam malesuada? Per.",5,1,"positive",21,22,5,4,2,2,4.33333333333333,"Contagion","Decreased",4,5,3,6,-1,1,1,4,2.5
"110",24,3,"Primis suspendisse posuere natoque cursus. At aliquam suspendisse viverra potenti tempora.","Donec atque dolorem nonummy sem imperdiet molestie urna! Vel rhoncus.",5,5,"positive",22,22,1,9,9,7,4.33333333333333,"Contagion","Decreased",7,1,6,8,6,-8,-3,1,-1
"111",46,4,"In posuere dui? Tempor montes nullam magnis magnis! In auctor ridiculus donec lectus.","Duis dolor blandit sed dictumst potenti nibh, sodales faucibus sodales sit pede! Elementum pretium non.",3,6,"positive",22,22,1,6,4,5,7,"Contagion","Decreased",9,2,9,8,8,-4,5,3,4
"112",66,4,"Aliquam convallis ut morbi potenti commodo mi mi vivamus tincidunt luctus.","Proin elit blandit nibh! Dapibus malesuada tortor? Per ligula est. Tempus vestibulum felis urna.",3,5,"positive",22,21,1,2,5,2,4.66666666666667,"Contagion","Decreased",8,9,5,6,7,7,0,4,2
"113",99,4,"Sagittis ac leo morbi gravida pede leo vulputate rutrum ipsum? Rhoncus iaculis porta.","Nibh commodo mattis erat sapien ultricies interdum integer dignissim neque.",4,7,"positive",22,22,4,4,1,6,5.33333333333333,"Contagion","Decreased",1,2,7,3,-3,-2,6,-3,1.5
"114",56,2,"Cras ut eleifend enim, convallis dui mauris aliquet consequat fringilla urna fringilla cras.","Suspendisse pede suspendisse accusamus tempora tortor morbi facilisis aliquet vestibulum a.",6,6,"positive",21,22,1,7,5,9,6.66666666666667,"Contagion","Decreased",7,6,3,6,6,-1,-2,-3,-2.5
"115",56,3,"Eleifend ultricies maecenas ac consectetuer tincidunt magnis massa posuere mattis tincidunt metus! Leo ac.","Ultrices lectus natoque suspendisse vel blandit urna amet. Nullam fusce, est rutrum fringilla tincidunt quis.",3,5,"positive",22,21,2,6,2,2,5,"Contagion","Decreased",3,6,5,2,1,0,3,0,1.5
"116",44,2,"Viverra justo posuere. Integer magnis. Cursus cras natoque mauris pretium. Bibendum nec vitae primis.","Aliquet. Purus suscipit eros est vitae culpa molestie! Duis quis.",6,1,"positive",21,22,6,4,9,1,5.66666666666667,"Contagion","Decreased",4,5,5,8,-2,1,-4,7,1.5
"117",43,1,"Aliquam risus ab, posuere. Volutpat ultrices justo aenean rutrum sagittis! Cras? Justo aliquet interdum.","Maecenas porta sem! Amet proin sem dolorem nec ultricies ut et fringilla.",2,5,"positive",21,21,2,4,2,5,5,"Contagion","Decreased",9,1,2,9,7,-3,0,4,2
"118",24,1,"Molestie porta luctus lorem. Suscipit luctus accusamus nulla augue enim! Porta dolor.","Ultrices orci nullam. Risus velit urna sollicitudin. Duis eleifend, est? Est felis massa vel.",6,3,"positive",22,21,2,2,2,1,4.66666666666667,"Contagion","Decreased",2,9,8,2,0,7,6,1,3.5
"119",8,3,"Lectus blandit. Iaculis. Tellus purus, faucibus mi sodales. Fermentum? Rutrum. Quis odio.","Dapibus odio viverra aenean gravida dapibus. Rhoncus felis dictumst leo urna justo? At.",4,1,"positive",22,21,3,7,4,8,4.33333333333333,"Contagion","Decreased",4,1,9,2,1,-6,5,-6,-0.5
"120",94,4,"Faucibus eget aliquam tempor maecenas risus praesent amet etiam, sed nec.","Tincidunt ultricies quam vitae malesuada, accusamus metus sed mauris dictumst diam accusamus odio! Luctus placerat.",4,4,"positive",22,22,6,6,8,9,6.66666666666667,"Contagion","Decreased",6,4,3,3,0,-2,-5,-6,-5.5
"121",9,4,"Aliquet gravida atque donec sed velit consequat consectetuer dictumst. Porttitor dolorem pellentesque cursus vehicula.","Duis commodo eu amet blandit sed arcu sollicitudin ac non, mattis posuere. Gravida consequat odio.",5,3,"positive",21,22,5,6,9,5,4.33333333333333,"Contagion","Decreased",9,5,7,6,4,-1,-2,1,-0.5
"122",88,1,"Neque sit mauris! Nibh nibh et. Sem ut. Ultricies rutrum ac ultrices augue vitae.","Ante viverra. Ultricies lacus molestie. Ridiculus! Eros neque ultricies dignissim leo cras ut.",6,1,"positive",22,22,1,4,3,6,3.66666666666667,"Contagion","Decreased",4,6,6,1,3,2,3,-5,-1
"123",82,2,"Venenatis ante ab magnis. Molestie ac fusce bibendum vehicula duis odio accusamus aenean.","Consequat ridiculus facilisis fringilla aliquet natoque scelerisque accusamus porttitor natoque magnis, sed leo nonummy.",3,2,"positive",21,22,3,9,9,3,7,"Contagion","Decreased",1,5,5,1,-2,-4,-4,-2,-3
"124",35,3,"Elit lorem magnis pede dictumst sit et posuere interdum. Pretium lectus.","Vehicula facilisis velit pellentesque ridiculus etiam diam? Nunc tellus? Vestibulum quam.",1,3,"positive",21,21,1,6,8,9,5,"Contagion","Decreased",9,3,5,5,8,-3,-3,-4,-3.5
"125",40,4,"Euismod. Dolorem suspendisse leo placerat et! Ab suscipit amet dapibus sem.","Diam ligula proin molestie felis erat sed vitae blandit nunc magna accusamus! Tincidunt mi.",5,5,"positive",21,21,2,8,1,9,6,"Contagion","Decreased",5,2,1,8,3,-6,0,-1,-0.5
"126",27,1,"Neque at dolorem eget natoque urna nulla, tortor? Suspendisse ante cursus duis ullamcorper sodales.","Lorem nec ligula. Proin dolor ridiculus orci tempus gravida natoque nec justo accumsan auctor.",6,1,"positive",22,22,1,1,6,7,5.33333333333333,"Contagion","Decreased",2,8,7,9,1,7,1,2,1.5
"127",78,4,"Sapien. Pharetra dolorem. Rutrum ab auctor, lacus? Ultrices urna rhoncus.","Posuere, vel primis. Vehicula cursus! Enim venenatis tempus pellentesque imperdiet.",4,5,"positive",22,22,4,7,6,7,5,"Contagion","Decreased",1,5,6,3,-3,-2,0,-4,-2
"128",29,4,"Enim quis sapien praesent ac nonummy accusamus. Atque leo purus facilisis justo, dignissim.","Sodales scelerisque venenatis consectetuer! Ultrices natoque, ultricies a dolor tempor. Sapien.",5,5,"positive",22,22,7,1,1,9,3.33333333333333,"Contagion","Decreased",2,8,1,3,-5,7,0,-6,-3
"129",11,4,"Massa. Enim convallis laoreet. Risus. Vehicula vestibulum interdum ut lorem phasellus! Amet.","Donec, sollicitudin auctor primis orci praesent! Euismod ut primis dictumst! Eu temporibus per.",4,1,"positive",21,21,3,8,1,5,3.33333333333333,"Contagion","Decreased",6,5,9,9,3,-3,8,4,6
"130",7,3,"Ullamcorper sem arcu justo! Venenatis ab lectus, dui tellus per.","Scelerisque bibendum? Massa dictumst. Aenean est lacus auctor malesuada luctus. Proin suspendisse etiam tempora aliquam.",5,3,"positive",21,22,4,9,5,1,5.33333333333333,"Contagion","Decreased",1,8,4,2,-3,-1,-1,1,0
"131",54,1,"Amet pellentesque aliquet, venenatis eu ridiculus at felis imperdiet sollicitudin consectetuer. Dui. Viverra, blandit faucibus.","Sagittis. Nonummy praesent consectetuer sit, purus sed elit volutpat, accumsan.",6,2,"positive",22,21,1,4,8,9,4.33333333333333,"Contagion","Decreased",7,5,3,9,6,1,-5,0,-2.5
"132",67,2,"Pellentesque aenean maecenas per enim est dui accumsan. Primis ac.","Ultricies sagittis euismod? Eros? Ut at aliquet nonummy, rhoncus! Dapibus! Dolorem leo dolor dui.",5,2,"positive",21,22,6,8,2,8,5.66666666666667,"Contagion","Decreased",1,4,1,4,-5,-4,-1,-4,-2.5
"133",65,3,"Eros! Fermentum integer placerat justo dolorem nec luctus id ultrices vivamus lectus odio at laoreet.","Eleifend facilisi suspendisse ante velit ab aliquet? Platea sit nulla! Dignissim auctor felis lacus mi.",2,1,"positive",21,22,9,1,1,3,2.33333333333333,"Contagion","Decreased",2,9,8,6,-7,8,7,3,5
"134",87,4,"Est iaculis, dictumst? Ab atque ipsum maecenas suscipit accusamus. Ab egestas.","Felis, montes nullam porttitor egestas primis? Facilisi massa. Fusce mattis. Consequat nullam.",2,6,"positive",22,22,9,1,2,4,5.66666666666667,"Contagion","Decreased",2,6,7,2,-7,5,5,-2,1.5
"135",0,1,"Duis? Eleifend sollicitudin maecenas sit et quam. Nulla ridiculus eu nullam. Morbi sollicitudin malesuada.","Malesuada luctus potenti! Velit placerat bibendum justo, molestie velit lectus commodo ultrices egestas. Potenti eleifend.",2,3,"positive",22,21,4,8,6,2,3.66666666666667,"Contagion","Decreased",4,6,7,9,0,-2,1,7,4
"136",10,1,"Dui consectetuer! Dignissim id. Fermentum rhoncus! Augue placerat etiam rhoncus! Id vehicula eu montes.","Dolorem commodo duis sagittis phasellus mattis! Nibh a bibendum velit volutpat vestibulum neque ut.",6,2,"positive",22,22,3,3,4,8,7.66666666666667,"Contagion","Decreased",9,6,3,8,6,3,-1,0,-0.5
"137",72,1,"Aliquam aenean montes primis pede ut. Porta maecenas! Rutrum fermentum. Aenean! Curabitur. Morbi consectetuer.","Sagittis! Id aenean. Luctus molestie risus, augue felis viverra praesent, metus suscipit mattis amet.",3,2,"positive",22,21,4,3,2,2,5.33333333333333,"Contagion","Decreased",8,7,2,5,4,4,0,3,1.5
"138",83,2,"Phasellus per, tortor vel platea! Fusce in! Atque dui! Imperdiet nonummy ultricies et egestas sed.","Pharetra interdum tempus facilisi tellus non consectetuer ligula luctus! Porta tempor potenti nonummy, auctor vel.",6,6,"positive",21,21,5,2,2,3,5.33333333333333,"Contagion","Decreased",4,6,9,7,-1,4,7,4,5.5
"139",77,1,"Massa dictumst? Proin vehicula vivamus neque arcu. Fermentum pharetra! Facilisis pede blandit, leo.","Iaculis potenti justo ante. Convallis fringilla eleifend consequat leo! Ridiculus venenatis.",6,7,"positive",21,22,9,5,1,6,4,"Contagion","Decreased",4,9,4,9,-5,4,3,3,3
"140",12,3,"Massa ab dictumst atque? Cursus arcu donec convallis nonummy ac amet volutpat eros facilisis sollicitudin.","Ac rhoncus phasellus. Ab vivamus mattis! Rhoncus. Culpa nibh natoque. Suspendisse quis.",3,1,"positive",21,22,1,3,7,7,5,"Contagion","Decreased",1,9,8,2,0,6,1,-5,-2
"141",75,3,"Pharetra porta atque mi facilisi nonummy molestie nec ab ullamcorper ligula dui nunc.","Aliquam imperdiet temporibus turpis nullam et, vulputate. Risus diam accusamus blandit, massa.",2,2,"positive",22,21,9,6,9,1,6,"Contagion","Decreased",4,3,9,1,-5,-3,0,0,0
"142",59,2,"Placerat. Dapibus consectetuer, eleifend ab elit donec justo laoreet ridiculus ridiculus interdum viverra.","Vel sollicitudin leo nullam lectus. Pretium? Justo. Augue lectus? Orci ab primis praesent. Ultrices platea.",5,5,"positive",21,21,6,9,9,2,3,"Contagion","Decreased",2,5,9,8,-4,-4,0,6,3
"143",100,4,"Turpis est. Sagittis mauris porttitor ultricies metus imperdiet consequat nunc erat ultrices morbi ab neque.","Morbi fermentum, massa felis eget amet faucibus. Iaculis. Id! Faucibus suscipit. Luctus.",3,6,"positive",22,21,1,6,8,8,5,"Contagion","Decreased",1,4,9,1,0,-2,1,-7,-3
"144",20,4,"Facilisi turpis aenean pellentesque! Id! Erat placerat, rutrum pellentesque! Dictumst sagittis ab posuere. Leo.","Potenti? Aliquet quis dui nec et in? Eros velit gravida egestas dictumst felis luctus! Sollicitudin.",6,5,"positive",22,22,2,6,2,5,4.33333333333333,"Contagion","Decreased",8,1,9,7,6,-5,7,2,4.5
"145",99,2,"Mi ipsum potenti leo montes malesuada phasellus ab eleifend culpa dignissim. Ipsum.","Cursus! Felis risus. Lacus cursus tincidunt. Malesuada consectetuer augue luctus ut! Per proin ullamcorper accusamus.",3,2,"positive",22,21,6,2,7,2,6,"Contagion","Decreased",4,9,1,8,-2,7,-6,6,0
"146",2,2,"Orci nonummy dapibus proin eleifend posuere? Laoreet temporibus maecenas erat.","Vestibulum ipsum est ullamcorper, malesuada nec justo. Felis placerat luctus praesent? Maecenas, vehicula.",6,3,"positive",21,22,7,3,6,6,2.66666666666667,"Contagion","Decreased",5,1,3,6,-2,-2,-3,0,-1.5
"147",92,3,"Non sapien, integer amet sapien convallis commodo sollicitudin magna ante.","Vehicula? Etiam consequat natoque? Sed elit! Bibendum euismod lectus? Vehicula potenti.",6,1,"positive",21,21,7,8,3,1,3,"Contagion","Decreased",3,8,6,4,-4,0,3,3,3
"148",70,4,"Fringilla tincidunt accumsan porta dolorem phasellus a id et? Leo posuere purus lorem.","Tempus purus arcu? Nulla nec sagittis accusamus erat venenatis tortor.",3,4,"positive",21,21,7,8,5,9,3.66666666666667,"Contagion","Decreased",2,4,3,4,-5,-4,-2,-5,-3.5
"149",19,4,"Tincidunt praesent scelerisque sit tincidunt ab etiam laoreet neque wisi malesuada suspendisse sem.","Aliquam aenean atque elementum ridiculus donec temporibus! Aliquam praesent. Natoque mattis risus. Integer.",6,7,"positive",21,22,2,9,5,3,5.33333333333333,"Contagion","Decreased",2,9,8,3,0,0,3,0,1.5
"150",89,4,"Lacus bibendum odio iaculis cras consequat pellentesque sed, est sollicitudin.","Curabitur faucibus aliquam integer lacus? Id! Turpis duis suspendisse placerat mattis fusce curabitur ante.",4,4,"positive",22,21,7,4,1,5,3,"Contagion","Decreased",1,9,4,5,-6,5,3,0,1.5
"151",26,1,"Ut porttitor iaculis. Magnis commodo eleifend lorem! Montes massa posuere quam.","Porttitor tincidunt phasellus purus pede nonummy montes ab? Porta! Elementum.",5,5,"positive",21,21,5,3,5,5,3,"Contagion","Decreased",7,3,5,4,2,0,0,-1,-0.5
"152",97,4,"Temporibus auctor nonummy ultrices purus justo. Porta. Enim, purus. Accusamus, quis aliquam accusamus.","Sollicitudin facilisis. Pellentesque. Sit tincidunt sollicitudin, dictumst interdum nibh est consequat porttitor. Dui. Imperdiet sollicitudin.",3,5,"positive",21,22,8,8,5,5,6,"Contagion","Decreased",6,4,7,7,-2,-4,2,2,2
"153",85,1,"Porttitor pede vel consectetuer nullam vestibulum sed ullamcorper nibh bibendum atque ultricies.","Vivamus augue, est tincidunt, sodales ante ante gravida, amet suspendisse.",6,2,"positive",21,21,5,1,8,4,4.33333333333333,"Contagion","Decreased",3,5,3,2,-2,4,-5,-2,-3.5
"154",46,2,"Interdum augue sollicitudin eros nonummy mauris commodo accumsan interdum. Velit risus vulputate? Eros potenti. Dolorem.","Vulputate. Arcu egestas sit posuere cras imperdiet fermentum. Auctor magnis metus.",3,1,"positive",22,22,5,4,1,8,7.33333333333333,"Contagion","Decreased",4,9,3,9,-1,5,2,1,1.5
"155",0,3,"Scelerisque dui, amet at lacus sem nulla venenatis nec nullam lectus. Sem.","Cras, volutpat porttitor platea. Ullamcorper tempor cras nec euismod? Laoreet bibendum tincidunt porttitor lacus.",4,3,"positive",21,22,8,4,3,8,3.66666666666667,"Contagion","Decreased",4,3,3,8,-4,-1,0,0,0
"156",23,3,"Mauris tempor eget aliquet culpa iaculis vitae dignissim erat fusce? Culpa. Ut.","Atque sapien sapien massa lectus. Purus at laoreet aliquam viverra. Vel. Volutpat.",1,7,"positive",22,22,7,5,2,1,3.66666666666667,"Contagion","Decreased",6,4,8,5,-1,-1,6,4,5
"157",85,2,"Malesuada consectetuer facilisi eget vehicula erat, sapien? Risus nec accusamus pretium.","Primis laoreet, eros pede cursus sagittis pharetra dolor velit primis quam maecenas platea.",2,7,"positive",22,21,1,7,1,9,3.66666666666667,"Contagion","Decreased",1,4,7,3,0,-3,6,-6,0
"158",8,2,"Placerat nunc dolor dolorem potenti felis venenatis. Erat curabitur convallis placerat, ullamcorper rhoncus nullam, eros.","Magnis atque? Morbi! Urna duis ullamcorper. Massa venenatis commodo pellentesque felis mattis.",6,4,"positive",22,21,4,5,4,8,6.33333333333333,"Contagion","Decreased",1,7,9,2,-3,2,5,-6,-0.5
"159",59,3,"Molestie? Fusce phasellus culpa massa tortor leo lectus elit etiam et diam per neque.","Sollicitudin ullamcorper posuere platea ultrices curabitur arcu donec. Vel! Primis enim purus elit.",4,3,"positive",22,21,8,9,4,2,7,"Contagion","Decreased",8,1,9,3,0,-8,5,1,3
"160",1,1,"Tincidunt odio lectus fermentum pharetra natoque praesent risus phasellus accumsan per elit ipsum.","Facilisis vestibulum mattis? Risus leo dictumst natoque lorem, imperdiet leo placerat. Primis tortor.",1,2,"positive",22,21,4,6,6,2,3.33333333333333,"Contagion","Decreased",5,1,4,6,1,-5,-2,4,1
"161",33,3,"Mauris faucibus egestas leo a nec aliquet massa metus accusamus.","At pellentesque. Odio tincidunt facilisis commodo sem venenatis potenti lorem quis quam facilisis.",3,4,"positive",22,21,5,2,7,2,3,"Market Value","Highlighted",6,8,3,7,1,6,-4,5,0.5
"162",33,4,"Metus scelerisque risus cursus justo! Tincidunt est laoreet porttitor sodales lectus ultrices justo atque.","Sodales. Nibh leo convallis. Suspendisse integer velit metus eu. Metus urna.",5,4,"positive",22,21,2,6,5,8,5.33333333333333,"Market Value","Highlighted",7,3,7,3,5,-3,2,-5,-1.5
"163",9,1,"Dui praesent vitae gravida maecenas purus nulla facilisis donec. Sagittis blandit.","Aliquam aliquam. Dictumst commodo faucibus. Felis scelerisque. Magna purus, auctor aenean molestie? Proin.",4,6,"positive",22,22,6,8,5,8,4.66666666666667,"Market Value","Highlighted",8,7,7,7,2,-1,2,-1,0.5
"164",54,1,"Auctor, malesuada culpa nonummy urna magna gravida! Pellentesque! Porta. Erat.","Posuere gravida pede amet venenatis neque est imperdiet in eleifend neque ligula magnis.",3,2,"positive",22,21,7,5,8,6,4.66666666666667,"Market Value","Highlighted",5,5,3,1,-2,0,-5,-5,-5
"165",1,2,"Tellus. In? Facilisi euismod blandit fusce nonummy leo vivamus elementum! Pretium dictumst. Vivamus cursus dolorem.","Elit blandit id convallis odio rutrum at vel! Tincidunt. Facilisis culpa! Convallis sollicitudin.",3,3,"positive",21,22,2,7,8,6,6.33333333333333,"Market Value","Highlighted",6,3,9,6,4,-4,1,0,0.5
"166",26,1,"Tempora platea! Nibh ut non! Morbi lectus tellus dignissim eros ultrices? Mauris. Mauris dui.","Mauris erat euismod enim accumsan suspendisse nonummy tempor dolor. Ante, interdum ultricies non turpis.",2,2,"positive",21,21,6,4,6,9,3.33333333333333,"Market Value","Highlighted",9,1,8,1,3,-3,2,-8,-3
"167",1,3,"Diam. Risus wisi dignissim ullamcorper cras convallis ut. Maecenas fringilla turpis sem. Elementum fermentum montes.","Suspendisse. Erat arcu lorem dignissim aliquet eu risus tempora nec. Sem bibendum blandit elit.",2,3,"positive",21,22,6,7,8,1,4,"Market Value","Highlighted",4,6,7,1,-2,-1,-1,0,-0.5
"168",17,2,"Viverra eleifend cursus? A donec. Leo vestibulum orci. Culpa id? Montes.","Ac volutpat! Lectus atque egestas aliquet maecenas, nec nec ut. Nullam proin. Porttitor imperdiet. Lorem.",3,6,"positive",22,21,8,4,1,2,4.66666666666667,"Market Value","Highlighted",2,1,3,1,-6,-3,2,-1,0.5
"169",29,2,"Pharetra curabitur aliquam quis nec vitae at facilisis odio, tincidunt.","Ultricies duis, accumsan montes augue ac at. Et leo aenean blandit egestas erat felis.",2,3,"positive",21,22,8,4,1,8,3.66666666666667,"Market Value","Highlighted",8,1,7,1,0,-3,6,-7,-0.5
"170",58,1,"Lectus dolor consectetuer! Vehicula, auctor suspendisse per id? Augue pharetra rutrum pede justo.","Facilisi sit maecenas? Faucibus potenti per iaculis eget vehicula wisi amet et.",5,4,"positive",21,22,2,8,7,7,5.33333333333333,"Market Value","Highlighted",2,2,2,9,0,-6,-5,2,-1.5
"171",46,2,"Viverra porta? Fermentum sapien egestas dolorem erat tempora dolor nonummy commodo scelerisque. Curabitur suscipit.","Quam neque nec magnis volutpat nullam ultrices et malesuada lacus temporibus! Velit.",6,1,"positive",21,22,1,9,9,6,6.33333333333333,"Market Value","Highlighted",6,4,8,5,5,-5,-1,-1,-1
"172",59,2,"Ut diam amet magnis venenatis ante posuere cras ipsum venenatis dictumst malesuada vestibulum.","Porta pellentesque bibendum nunc consectetuer venenatis blandit orci ut convallis sagittis. Odio.",6,1,"positive",22,22,1,1,7,8,4.66666666666667,"Market Value","Highlighted",4,5,7,8,3,4,0,0,0
"173",49,3,"Mattis nulla? Mattis integer. Consectetuer ligula non consectetuer, cursus. Aliquam magna.","Eros nec. Massa ac potenti tempus dapibus! Amet tincidunt nec convallis vitae phasellus.",4,7,"positive",21,21,9,3,6,3,5.33333333333333,"Market Value","Highlighted",3,2,2,9,-6,-1,-4,6,1
"174",52,1,"Tempora aliquet sed primis, nec duis culpa morbi euismod fusce dictumst diam scelerisque.","Cursus tellus lectus molestie temporibus ante iaculis iaculis arcu! Dapibus augue.",3,1,"positive",21,22,7,3,3,9,4.33333333333333,"Market Value","Highlighted",3,5,7,8,-4,2,4,-1,1.5
"175",67,3,"Dolor, dictumst fringilla? Temporibus cursus augue. Id vehicula, facilisis tortor.","Curabitur montes consequat blandit pretium non urna lacus sollicitudin consectetuer vestibulum quis dictumst quam.",1,1,"positive",21,21,8,8,9,7,5.33333333333333,"Market Value","Highlighted",6,5,3,9,-2,-3,-6,2,-2
"176",60,3,"Ullamcorper luctus, vehicula vitae! Sapien. Tempus non vehicula ante ab. Wisi duis cras nullam.","Ab nulla molestie potenti est. Rhoncus magna pretium metus blandit.",1,3,"positive",21,22,9,6,9,1,6,"Market Value","Highlighted",8,3,2,2,-1,-3,-7,1,-3
"177",69,4,"Curabitur viverra massa maecenas dolorem aliquam, gravida pede ullamcorper? Fringilla primis dolor.","Felis nunc risus enim fermentum enim dolorem! Ab pharetra non, sapien integer.",1,7,"positive",22,22,3,7,8,8,2.66666666666667,"Market Value","Highlighted",5,3,2,1,2,-4,-6,-7,-6.5
"178",49,1,"Volutpat magna fringilla leo. Bibendum enim praesent in purus urna! Temporibus praesent sit.","Dolorem placerat, dignissim faucibus fermentum a. Porttitor facilisis wisi nunc accumsan non! Rutrum fringilla.",1,1,"positive",21,22,1,4,3,4,4.66666666666667,"Market Value","Highlighted",6,6,6,8,5,2,3,4,3.5
"179",53,4,"Vehicula imperdiet nonummy imperdiet pretium fusce proin elit rhoncus metus pharetra. Ut.","Erat vel vehicula imperdiet mauris nunc, dictumst leo primis natoque? Tincidunt pellentesque? Neque.",4,1,"positive",21,21,1,4,5,3,4.33333333333333,"Market Value","Highlighted",8,4,2,4,7,0,-3,1,-1
"180",13,4,"Ab suscipit sed neque viverra cursus luctus arcu curabitur. Aenean porta integer.","Interdum cras lacus ab turpis et etiam. Scelerisque fringilla nibh diam dignissim justo nonummy.",1,4,"positive",21,21,1,4,8,5,5.66666666666667,"Market Value","Highlighted",9,4,2,5,8,0,-6,0,-3
"181",5,3,"Cras accusamus dolor magnis. Consequat ullamcorper venenatis accumsan consequat rhoncus ut velit laoreet phasellus amet.","Iaculis atque metus tempor, nibh mattis wisi. Nunc ipsum! Suspendisse aliquet. Lorem molestie ligula.",1,7,"positive",22,22,8,1,9,4,4.66666666666667,"Market Value","Highlighted",1,8,6,5,-7,7,-3,1,-1
"182",13,4,"Dignissim dapibus vel massa aliquet vel dolor, iaculis. Arcu wisi amet, integer nunc at.","Felis ante dolor montes neque rutrum turpis faucibus mauris pretium eget dolor.",2,5,"positive",21,21,1,1,4,7,5.33333333333333,"Market Value","Highlighted",8,4,7,9,7,3,3,2,2.5
"183",6,1,"Porttitor vel pharetra at magna a vel faucibus nullam? Sit eleifend arcu atque convallis fusce.","Tempor accumsan per wisi vitae sollicitudin posuere! Natoque vivamus proin ultrices at montes. Massa.",5,1,"positive",21,22,6,5,7,8,5,"Market Value","Highlighted",5,7,1,3,-1,2,-6,-5,-5.5
"184",47,4,"Porta facilisi vitae justo sapien. Faucibus. Culpa cras nullam? Nulla.","Nullam etiam massa dui elit, ab orci faucibus consectetuer, duis viverra. Sollicitudin.",3,7,"positive",22,22,7,2,7,5,6.33333333333333,"Market Value","Highlighted",8,9,2,6,1,7,-5,1,-2
"185",87,2,"Enim eleifend elementum ab turpis in sapien lectus magna elementum? Etiam ante. Ullamcorper imperdiet facilisi.","Nulla. Eleifend velit culpa. Interdum atque vitae sodales magna mauris montes.",5,7,"positive",22,21,7,6,2,3,4.66666666666667,"Market Value","Highlighted",4,4,6,4,-3,-2,4,1,2.5
"186",26,2,"Suscipit consectetuer bibendum ante rutrum posuere porttitor. Sollicitudin? Quis ut suspendisse.","Maecenas in sem commodo pellentesque fringilla purus tincidunt culpa morbi.",1,2,"positive",21,21,5,4,8,4,5.33333333333333,"Market Value","Highlighted",2,5,1,7,-3,1,-7,3,-2
"187",35,4,"Aenean amet sem volutpat nunc elementum montes ac blandit viverra! Diam aliquet interdum.","Gravida tempora id placerat, metus potenti montes. Id gravida auctor magna pellentesque.",1,4,"positive",22,21,8,7,6,6,5,"Market Value","Highlighted",8,8,9,9,0,1,3,3,3
"188",24,3,"Accumsan, arcu rutrum risus praesent! Temporibus lacus est mattis maecenas convallis eget.","Aliquet non scelerisque, dolor cras aliquet. Viverra, ipsum commodo. Curabitur, felis. Natoque sit vulputate.",3,3,"positive",22,22,7,7,2,8,4,"Market Value","Highlighted",2,4,7,9,-5,-3,5,1,3
"189",61,2,"Justo aliquet. Nulla, ultricies lorem viverra atque facilisi natoque nullam erat cursus.","Vel nibh vivamus tempora. Nulla dolorem. Curabitur eleifend metus! Tempora ultrices, placerat fermentum sagittis.",2,1,"positive",21,22,3,8,7,3,8,"Market Value","Highlighted",7,8,7,8,4,0,0,5,2.5
"190",97,4,"Culpa tempor justo? Iaculis laoreet at. Consequat natoque pellentesque donec porta! Eleifend.","Nunc culpa eros morbi praesent scelerisque dui maecenas iaculis? Sollicitudin vitae.",3,6,"positive",22,22,7,9,1,5,8,"Market Value","Highlighted",3,2,5,9,-4,-7,4,4,4
"191",73,1,"Vehicula luctus erat lorem ultricies? Proin montes rhoncus. Consequat lacus.","At posuere arcu ac vestibulum per nec euismod? Nulla quam mi! Aliquet facilisi.",5,1,"positive",22,21,1,7,9,9,6,"Market Value","Highlighted",5,4,8,3,4,-3,-1,-6,-3.5
"192",52,2,"Molestie! Ridiculus! A nonummy ultrices commodo blandit, non rutrum sollicitudin.","Vitae praesent primis euismod temporibus pellentesque, non enim! Ac eu sodales.",6,1,"positive",21,22,8,5,1,3,5.66666666666667,"Market Value","Highlighted",7,4,8,3,-1,-1,7,0,3.5
"193",96,1,"Commodo imperdiet ligula vulputate lorem! Magnis magna pede porttitor? Tellus dapibus enim non elit.","Montes dui ac, ridiculus sollicitudin orci natoque! Vulputate cras in laoreet dolorem nulla vitae.",5,4,"positive",21,22,6,4,9,1,5.33333333333333,"Market Value","Highlighted",7,8,9,6,1,4,0,5,2.5
"194",30,4,"Id! Metus! Nullam, consequat non montes magna ligula. Sollicitudin velit nec. Orci vehicula.","Erat eleifend. Molestie. Blandit enim pharetra sodales id accumsan eleifend. Elit.",2,6,"positive",21,21,7,2,5,9,4.66666666666667,"Market Value","Highlighted",9,6,8,5,2,4,3,-4,-0.5
"195",45,4,"Purus wisi lorem risus convallis tortor ridiculus curabitur id eu urna enim.","Leo laoreet lectus. Turpis est gravida maecenas venenatis sodales pretium! Urna porta in cursus convallis.",5,3,"positive",22,22,1,4,2,9,6.33333333333333,"Market Value","Highlighted",2,1,7,9,1,-3,5,0,2.5
"196",40,3,"Wisi urna tincidunt morbi sit eleifend, montes? Sed? Vulputate faucibus. Fermentum.","Vivamus montes pretium montes nibh turpis aliquet sapien risus cras viverra cursus gravida elementum.",1,4,"positive",22,21,8,8,4,5,6,"Market Value","Highlighted",7,9,2,5,-1,1,-2,0,-1
"197",47,4,"Montes et eget, quis! Donec mi amet eleifend leo sapien quam dapibus.","Purus quis per vestibulum enim nunc diam donec vivamus potenti.",3,5,"positive",22,22,2,8,1,1,6,"Market Value","Highlighted",4,1,2,3,2,-7,1,2,1.5
"198",82,1,"Ab? Erat suscipit, malesuada id duis atque? Volutpat, cursus mattis magna! Sem ab maecenas aenean.","Cursus fringilla id magnis tortor dolorem tincidunt lacus eu leo eu ridiculus porttitor vivamus.",3,3,"positive",21,21,2,4,6,7,6,"Market Value","Highlighted",8,7,5,3,6,3,-1,-4,-2.5
"199",94,4,"Augue fermentum. Dui eu fringilla pretium! Dapibus ullamcorper? Vestibulum duis proin volutpat.","Natoque. Imperdiet ullamcorper ligula sem. Velit porttitor. Euismod montes. Et.",4,4,"positive",22,21,5,6,9,3,2.66666666666667,"Market Value","Highlighted",4,5,1,8,-1,-1,-8,5,-1.5
"200",12,1,"Ligula iaculis laoreet. Facilisi scelerisque proin magnis facilisi urna viverra placerat arcu. Sollicitudin.","Sem purus nonummy dui elementum rutrum nec temporibus? Pede placerat? Bibendum eget fringilla tortor fringilla.",6,5,"positive",21,22,3,3,6,9,6.66666666666667,"Market Value","Highlighted",9,9,3,3,6,6,-3,-6,-4.5
"201",27,1,"Elit ligula eros! Ullamcorper porttitor pellentesque fermentum cras turpis. Convallis? Lectus ac non erat.","Augue aliquet pretium sapien vulputate. Dictumst non facilisis tellus iaculis vehicula duis montes arcu at.",5,3,"positive",22,22,6,9,6,1,4.33333333333333,"Market Value","Highlighted",4,7,6,8,-2,-2,0,7,3.5
"202",66,3,"Diam curabitur? Orci? Est ante in accusamus laoreet sollicitudin ipsum primis! Suscipit.","Molestie? Commodo sed accusamus nonummy faucibus bibendum commodo posuere ligula.",1,7,"positive",22,22,1,1,4,4,5.66666666666667,"Market Value","Highlighted",3,3,2,1,2,2,-2,-3,-2.5
"203",92,4,"Aliquam scelerisque consectetuer metus! Vel sodales non interdum venenatis facilisis.","Venenatis consectetuer praesent mauris tellus accumsan fringilla scelerisque auctor bibendum nibh ligula.",2,5,"positive",21,22,2,6,9,1,6,"Market Value","Highlighted",3,5,6,9,1,-1,-3,8,2.5
"204",71,4,"Dapibus accumsan aliquam. Vehicula donec eget consectetuer lacus per! Consequat fringilla.","Mauris eget lectus, phasellus odio facilisi scelerisque fringilla tellus, lorem augue vel id rutrum massa.",5,3,"positive",22,22,5,1,3,4,2.66666666666667,"Market Value","Highlighted",5,8,3,1,0,7,0,-3,-1.5
"205",23,4,"Facilisis! Mattis vestibulum imperdiet phasellus metus id pharetra dictumst. Cras.","Ipsum tortor massa lectus lorem. Fringilla consectetuer rutrum. Ipsum eros tempus.",6,3,"positive",22,21,3,1,3,1,4.33333333333333,"Market Value","Highlighted",1,8,8,7,-2,7,5,6,5.5
"206",66,4,"Eleifend pellentesque consequat purus etiam bibendum. Sagittis consequat venenatis fringilla tortor, egestas euismod.","Consectetuer, pharetra! Risus. Nec? Lorem quam. Sem fermentum pretium in? Enim duis, quis dignissim.",5,1,"positive",22,22,5,7,4,6,3.66666666666667,"Market Value","Highlighted",1,9,5,8,-4,2,1,2,1.5
"207",12,4,"Rhoncus accumsan! Non ipsum ligula pellentesque curabitur rhoncus eleifend! Commodo.","Magnis integer placerat fringilla tincidunt malesuada nulla lacus tempus mauris ac ridiculus justo magna venenatis.",6,5,"positive",22,21,9,1,1,2,5.33333333333333,"Market Value","Highlighted",5,7,7,9,-4,6,6,7,6.5
"208",31,2,"Neque integer. Arcu, sagittis gravida vel. Est nulla leo eros.","Praesent aliquet justo! Non elementum bibendum eu donec mi massa et.",3,4,"positive",21,22,6,8,7,6,2.66666666666667,"Market Value","Highlighted",2,4,6,1,-4,-4,-1,-5,-3
"209",97,4,"Posuere cursus. Interdum eu? Vel at euismod, facilisi. Facilisis vel! Risus ante neque.","Interdum posuere ultrices erat eleifend consequat risus mattis porttitor suspendisse blandit nulla.",3,7,"positive",21,21,4,1,8,4,6.33333333333333,"Market Value","Highlighted",6,2,1,7,2,1,-7,3,-2
"210",67,4,"Porta mi nonummy duis at? Ab suspendisse neque nec eget.","Porta euismod sollicitudin arcu et nullam. A culpa placerat justo, malesuada dignissim quis dui. Magnis.",4,2,"positive",21,22,7,7,5,1,3.66666666666667,"Market Value","Highlighted",7,2,7,9,0,-5,2,8,5
"211",82,1,"Eros. Turpis, potenti convallis eros id sodales? Ab vehicula magna temporibus.","Erat. Suscipit! Ab. Arcu odio diam risus ab ultrices morbi eu egestas.",6,6,"positive",22,22,8,3,8,2,8,"Market Value","Highlighted",4,7,2,3,-4,4,-6,1,-2.5
"212",80,2,"Viverra interdum porttitor vivamus. Lacus, fringilla ut aenean! Curabitur, gravida suscipit ac. Eros ab.","Sollicitudin! Tincidunt in at! Id. Venenatis nec massa facilisi sed enim ut et. Ipsum turpis.",4,1,"positive",21,21,9,2,9,3,6.33333333333333,"Market Value","Highlighted",1,2,8,6,-8,0,-1,3,1
"213",20,1,"Primis bibendum! Accumsan, nunc mi urna. Leo, sodales ante? Tempor a posuere a dapibus. Fringilla.","Arcu. Sodales sodales nec! Erat dolorem ac! Orci odio, purus rhoncus, duis culpa.",1,5,"positive",21,21,9,5,3,5,4.33333333333333,"Market Value","Highlighted",3,7,6,3,-6,2,3,-2,0.5
"214",0,2,"Suspendisse ultrices quis. Interdum accumsan molestie urna vulputate commodo cursus per faucibus? Tortor pharetra! Est.","Porttitor sagittis duis ut diam praesent placerat velit ultricies platea nibh curabitur dignissim.",6,2,"positive",22,21,1,3,7,1,3.66666666666667,"Market Value","Highlighted",6,8,6,3,5,5,-1,2,0.5
"215",69,1,"Praesent platea atque eleifend fringilla bibendum! Elit! Phasellus donec cursus ultricies in.","Tempor amet dictumst enim vivamus morbi sapien, aliquam vel luctus elementum malesuada leo molestie.",2,4,"positive",21,22,2,6,3,9,4.33333333333333,"Market Value","Highlighted",7,5,1,5,5,-1,-2,-4,-3
"216",61,1,"Ab, blandit. Potenti wisi curabitur nibh neque, ut ultrices tortor. Natoque elit velit magna.","Felis sagittis interdum viverra quis, convallis, potenti placerat arcu rhoncus dolorem.",1,2,"positive",22,21,5,7,3,3,4.66666666666667,"Market Value","Highlighted",7,7,5,1,2,0,2,-2,0
"217",66,3,"Phasellus pretium iaculis erat tempus consectetuer tellus, vehicula aliquet fringilla? Rutrum accusamus diam arcu.","Pretium praesent elit tempor erat, facilisi vehicula vitae risus eget.",5,2,"positive",21,21,6,5,6,9,4,"Market Value","Highlighted",5,4,5,5,-1,-1,-1,-4,-2.5
"218",2,2,"Laoreet laoreet suscipit quam placerat cras. Temporibus. Vestibulum sodales pellentesque.","Commodo platea suspendisse nunc accusamus magnis facilisi dolor ligula tempor egestas! Molestie porta.",2,2,"positive",22,21,1,8,2,8,5.66666666666667,"Market Value","Highlighted",2,1,5,4,1,-7,3,-4,-0.5
"219",26,2,"Ultricies facilisis, elementum augue tempor et leo platea? Scelerisque pede iaculis fusce quam.","Vulputate ab eu? Felis? Vel phasellus ac sagittis fringilla accumsan ut dapibus rutrum tempus.",4,3,"positive",21,21,9,4,1,9,4,"Market Value","Highlighted",5,4,5,5,-4,0,4,-4,0
"220",68,2,"Atque. Enim lorem pede aliquet? Vitae maecenas quam aliquam pharetra.","Odio consectetuer etiam pellentesque pretium. Molestie donec, facilisis, in pellentesque morbi donec velit molestie? Commodo.",6,3,"positive",21,22,4,6,5,3,7.33333333333333,"Market Value","Highlighted",8,5,2,6,4,-1,-3,3,0
"221",93,2,"Cras! Magna ultrices tellus nullam nec sed risus egestas duis. Montes aliquet fringilla purus.","Morbi suspendisse sodales eleifend accumsan neque tempor montes eros? Vulputate. Commodo pretium.",4,5,"positive",21,21,5,9,9,4,7,"Market Value","Highlighted",5,4,1,2,0,-5,-8,-2,-5
"222",67,4,"Quam augue magnis praesent cras natoque ipsum nibh proin? Tempus risus felis.","Luctus dolor pede blandit ipsum cursus, iaculis rhoncus? Aliquam. Imperdiet magnis.",6,6,"positive",21,21,6,3,1,2,4,"Market Value","Highlighted",9,5,6,9,3,2,5,7,6
"223",76,4,"Posuere vitae arcu sagittis lacus commodo ridiculus mauris. Natoque atque, consectetuer. Ultricies.","Viverra consectetuer sed vestibulum porta elit rhoncus lacus luctus curabitur.",3,5,"positive",22,22,8,6,1,2,3.33333333333333,"Market Value","Highlighted",5,9,9,9,-3,3,8,7,7.5
"224",6,4,"Magnis wisi ligula cursus bibendum. Lacus? Iaculis, suscipit imperdiet? Pretium.","Eleifend facilisi sem orci nunc justo dignissim etiam. Tortor, nulla praesent cursus.",2,6,"positive",21,21,6,7,5,1,4.33333333333333,"Market Value","Highlighted",4,8,7,4,-2,1,2,3,2.5
"225",70,2,"Dapibus nullam luctus per? Laoreet viverra in donec natoque natoque neque imperdiet suspendisse sapien.","Placerat. Nonummy auctor phasellus. Nonummy. Cursus eget at est montes sodales, ab eu orci? Iaculis.",3,4,"positive",21,21,4,4,3,1,3.66666666666667,"Market Value","Highlighted",7,9,7,9,3,5,4,8,6
"226",92,1,"Praesent? In fermentum erat per bibendum. Dolorem? Pede natoque venenatis, egestas. Suscipit. Ultrices neque.","Tempus molestie platea volutpat ab dapibus placerat integer, a. Posuere accumsan, sapien.",3,2,"positive",22,22,5,6,5,6,6,"Market Value","Highlighted",7,2,3,4,2,-4,-2,-2,-2
"227",31,3,"Et velit porta vivamus nec facilisis. Ridiculus? Ante integer malesuada primis, dolor. Ipsum.","Scelerisque accumsan. Fermentum lorem! Temporibus pretium iaculis gravida ab? Vivamus? Vel sapien. Suspendisse.",2,5,"positive",22,22,8,3,7,8,5,"Market Value","Highlighted",1,1,9,5,-7,-2,2,-3,-0.5
"228",35,4,"Facilisis porttitor duis auctor interdum tincidunt proin vulputate pede? Temporibus.","Dolorem faucibus malesuada ligula ultricies augue? Dui pede eu sed imperdiet felis.",4,6,"positive",22,22,9,8,8,3,6,"Market Value","Highlighted",6,8,9,6,-3,0,1,3,2
"229",97,2,"Vehicula pharetra integer iaculis tempor donec fringilla vitae fusce elit.","Erat nulla leo proin. Tempora? Viverra. Sit ac, velit sollicitudin fringilla iaculis lectus.",6,6,"positive",22,21,3,7,8,4,7,"Market Value","Highlighted",8,4,2,5,5,-3,-6,1,-2.5
"230",35,1,"Ut! Est nonummy. Blandit nunc ante consequat! Justo! Risus suspendisse egestas. Urna ipsum tortor.","Aenean per facilisi ac maecenas. Nullam. Eleifend tempora dapibus laoreet.",5,1,"positive",22,22,3,8,2,2,3.66666666666667,"Market Value","Highlighted",1,5,4,8,-2,-3,2,6,4
"231",85,2,"Sed id sodales enim? Dolor sapien non egestas iaculis vehicula nulla. Vestibulum. Integer.","Iaculis a id proin est pede tempus neque magnis orci lorem facilisi aenean turpis.",2,2,"positive",22,21,8,2,6,9,4,"Market Value","Highlighted",9,8,3,6,1,6,-3,-3,-3
"232",53,2,"Id et, gravida integer? Ultricies blandit porta. Molestie? Pharetra. Ullamcorper vestibulum per wisi sapien morbi.","Curabitur felis mauris ridiculus natoque leo wisi eu euismod mi dictumst auctor! Sem facilisi.",4,4,"positive",21,21,2,4,7,5,5.33333333333333,"Market Value","Highlighted",7,9,3,2,5,5,-4,-3,-3.5
"233",9,2,"Nulla rhoncus. Rutrum. Sapien vulputate lorem? Eleifend sem etiam scelerisque aliquam tempora quam natoque.","Felis etiam ridiculus volutpat venenatis. Maecenas etiam facilisis diam imperdiet natoque risus a leo.",2,5,"positive",21,22,9,2,2,6,6.66666666666667,"Market Value","Highlighted",1,8,7,5,-8,6,5,-1,2
"234",30,4,"At eu nulla in proin consequat facilisi leo, sed faucibus platea ullamcorper egestas viverra ut.","Suscipit, suscipit, culpa, integer vulputate dignissim euismod, duis luctus justo.",6,2,"positive",22,22,4,4,6,5,4,"Market Value","Highlighted",2,5,8,9,-2,1,2,4,3
"235",26,4,"Porta in sagittis turpis faucibus porta vestibulum per pretium commodo. Eu et per.","Augue, vulputate facilisis ante. Faucibus metus odio! Nonummy nullam? Curabitur.",6,6,"positive",22,21,6,3,9,5,7.33333333333333,"Market Value","Highlighted",5,7,1,6,-1,4,-8,1,-3.5
"236",14,2,"Tincidunt auctor pretium nec per urna morbi sit vivamus, nonummy, ullamcorper! Pharetra justo.","Nec at, duis venenatis erat massa praesent sapien. Augue, ipsum enim nulla dignissim dolorem.",4,2,"positive",22,21,9,1,4,2,6.66666666666667,"Market Value","Highlighted",5,6,8,4,-4,5,4,2,3
"237",1,1,"Nullam tincidunt eleifend nullam consequat bibendum sodales accumsan dui duis, felis magna.","Lorem! Accumsan tempor, convallis dui et natoque commodo vitae dolorem sapien venenatis! At orci.",6,5,"positive",21,22,3,8,9,1,3,"Market Value","Highlighted",6,4,6,7,3,-4,-3,6,1.5
"238",27,4,"Nullam vitae ut porttitor ut sollicitudin et potenti lorem elit dapibus odio sapien augue.","Platea tortor vitae magna suscipit, aliquet sem dolorem natoque in dolorem.",1,7,"positive",22,21,9,4,2,2,7,"Market Value","Highlighted",4,8,1,8,-5,4,-1,6,2.5
"239",21,3,"Sollicitudin egestas primis curabitur! Posuere eget, imperdiet facilisi ante consequat phasellus sapien etiam! Vestibulum sapien.","Ab neque primis maecenas ridiculus laoreet? Interdum duis orci. In.",3,2,"positive",22,22,9,1,9,2,6.33333333333333,"Market Value","Highlighted",2,4,1,1,-7,3,-8,-1,-4.5
"240",71,2,"Tempor eleifend. Sit neque risus? At nulla? Sagittis tempor? Integer! Cursus pellentesque duis.","Scelerisque accusamus dolor etiam duis vestibulum! Dui? Felis accumsan sed facilisis vestibulum.",5,1,"positive",21,22,5,4,8,5,1.66666666666667,"Market Value","Highlighted",4,8,3,3,-1,4,-5,-2,-3.5
"241",20,2,"Venenatis tempor tempus laoreet! Mattis risus aliquam? Accusamus per, duis! Dolorem lacus accumsan.","Eros. Et aliquet ante dui tincidunt malesuada diam. Consectetuer consequat ab etiam! Sollicitudin. Vivamus.",2,4,"positive",22,22,1,6,7,2,3.33333333333333,"Market Value","Decreased",5,1,8,2,4,-5,1,0,0.5
"242",5,2,"Integer! Ligula eleifend, vehicula? Leo ab at gravida augue metus.","Nec tempus commodo ipsum nunc ante. Natoque eleifend cras ultrices eros viverra laoreet nullam.",4,1,"positive",22,22,1,4,1,8,7,"Market Value","Decreased",4,3,3,3,3,-1,2,-5,-1.5
"243",56,2,"Facilisis! Bibendum lectus temporibus montes suscipit ab, vestibulum nonummy atque vivamus.","Sodales, amet enim arcu dolor tincidunt convallis risus gravida. Justo, fermentum tempora, at.",3,4,"positive",21,22,1,1,2,8,3.66666666666667,"Market Value","Decreased",9,2,9,1,8,1,7,-7,0
"244",20,4,"Dolorem risus mi pellentesque sodales consectetuer pharetra imperdiet faucibus amet vel, facilisis. Platea metus erat.","Quam urna dignissim egestas odio. Proin sapien. Per wisi duis? A at pretium.",3,7,"positive",21,22,2,4,2,7,4.66666666666667,"Market Value","Decreased",3,5,1,1,1,1,-1,-6,-3.5
"245",58,1,"Potenti phasellus quam nonummy dapibus augue at ridiculus eros auctor augue.","Metus ante sollicitudin dignissim erat dapibus magnis risus. Cras ac placerat.",4,4,"positive",22,21,9,2,2,7,6.33333333333333,"Market Value","Decreased",4,3,6,3,-5,1,4,-4,0
"246",21,2,"Bibendum vivamus? Neque ut rutrum arcu amet sed eleifend rutrum est nunc nulla dolor pede.","Sem vivamus sagittis imperdiet temporibus dictumst est tellus porta. Nonummy erat! Nec? Ab suscipit.",5,5,"positive",21,21,5,8,7,4,7,"Market Value","Decreased",6,7,2,8,1,-1,-5,4,-0.5
"247",2,1,"Dui aliquam aliquam vivamus? Laoreet. Auctor porttitor pharetra ultricies facilisi tincidunt mattis.","Tempus cursus tortor? Ut suspendisse venenatis? Magna volutpat? Etiam sit neque sit pede auctor donec.",6,1,"positive",22,22,6,7,6,2,5.33333333333333,"Market Value","Decreased",4,9,5,6,-2,2,-1,4,1.5
"248",44,4,"Cras sagittis dui temporibus ridiculus. Felis. Commodo proin atque erat curabitur curabitur porttitor. Mauris et.","Odio eget? Dignissim morbi turpis id diam? Eleifend sapien posuere.",5,4,"positive",22,21,7,3,1,2,5.66666666666667,"Market Value","Decreased",9,8,1,3,2,5,0,1,0.5
"249",51,4,"Accumsan. Suspendisse. Vestibulum amet imperdiet duis tempus risus at nibh.","Sem accumsan arcu odio sagittis? Eleifend quam ullamcorper felis! Dolor risus est phasellus tempora consequat.",6,3,"positive",21,21,3,5,3,6,4.66666666666667,"Market Value","Decreased",5,5,2,5,2,0,-1,-1,-1
"250",48,1,"Potenti potenti tempor fusce faucibus pretium placerat pede aenean curabitur.","Tortor dui proin posuere eu rhoncus phasellus aliquet purus duis, tempor ligula.",1,6,"positive",21,22,3,2,2,6,4.33333333333333,"Market Value","Decreased",7,7,2,2,4,5,0,-4,-2
"251",6,2,"Vivamus consectetuer. Gravida dictumst, nonummy dui integer fermentum, nibh sed dictumst auctor, tincidunt.","Maecenas? Per? Luctus arcu sagittis culpa tortor rutrum erat leo! Erat porttitor.",1,1,"positive",22,21,8,4,8,5,3.33333333333333,"Market Value","Decreased",4,8,7,3,-4,4,-1,-2,-1.5
"252",81,4,"Magna nunc at phasellus urna culpa sit? Proin. Ante aliquet turpis purus ullamcorper.","Accusamus nibh elementum velit iaculis erat platea ut pede in convallis.",5,7,"positive",21,22,9,5,2,2,3.66666666666667,"Market Value","Decreased",4,7,3,3,-5,2,1,1,1
"253",10,3,"Ut ut vehicula fusce scelerisque sit aliquam, justo lacus lorem.","Elit consequat? Ultricies dolorem duis imperdiet purus. Consequat sed! Mi, rhoncus mauris dui curabitur iaculis.",6,5,"positive",22,22,7,7,4,6,3.33333333333333,"Market Value","Decreased",1,1,2,3,-6,-6,-2,-3,-2.5
"254",76,1,"Elementum nullam temporibus. Interdum ullamcorper mauris consequat, ante, quis? Vitae dignissim. Blandit sed? Commodo vulputate.","Proin nullam dictumst odio consectetuer. Ultrices per pretium. Euismod tempora lacus nibh ligula.",1,1,"positive",21,21,1,6,1,6,4.66666666666667,"Market Value","Decreased",2,1,8,9,1,-5,7,3,5
"255",10,1,"Aliquet metus quam tincidunt cursus commodo euismod montes posuere facilisis atque in ultricies suspendisse? Ut.","Tellus. Tortor dui tempor diam fringilla vitae vestibulum? Euismod dapibus sapien accumsan per.",5,1,"positive",22,22,6,9,4,6,4.33333333333333,"Market Value","Decreased",6,7,8,6,0,-2,4,0,2
"256",89,1,"Duis. Arcu augue! Pede fermentum sodales aliquam fusce blandit enim.","Suspendisse vitae ut luctus rutrum tempora diam lectus primis pede tellus pede.",1,2,"positive",21,22,8,7,8,8,5.33333333333333,"Market Value","Decreased",5,1,1,9,-3,-6,-7,1,-3
"257",18,4,"Pretium ridiculus interdum sodales. Etiam bibendum vivamus a donec tellus posuere molestie! Luctus montes! Sagittis.","Duis turpis porttitor? Ullamcorper fermentum magna tempor eget. Consequat wisi scelerisque! Ultrices porttitor.",1,7,"positive",22,21,5,2,2,4,2,"Market Value","Decreased",6,9,9,6,1,7,7,2,4.5
"258",69,1,"Facilisis mi ultrices dolorem, iaculis? Luctus praesent atque malesuada posuere sodales.","Maecenas. Sodales praesent vivamus risus egestas in! Fermentum nibh tempor atque. Venenatis pellentesque.",4,6,"positive",22,22,8,9,8,7,4,"Market Value","Decreased",7,3,1,6,-1,-6,-7,-1,-4
"259",45,4,"Vehicula. Viverra temporibus id dolor risus etiam? Montes velit pretium id.","Morbi sed sit blandit? Ultricies magna. Luctus et per quis. Urna! Magna luctus.",4,6,"positive",22,22,8,5,8,5,5,"Market Value","Decreased",5,5,7,6,-3,0,-1,1,0
"260",41,1,"Leo elit atque vel potenti per sit eros posuere pede euismod.","Dignissim velit imperdiet sollicitudin orci id ut, nunc fusce duis.",5,2,"positive",22,21,4,4,1,4,2.66666666666667,"Market Value","Decreased",4,4,5,7,0,0,4,3,3.5
"261",66,2,"Accusamus risus felis ante mauris imperdiet volutpat platea risus euismod ac nullam at montes montes.","Ultricies porta blandit. Vehicula dui scelerisque nonummy sollicitudin! Venenatis ut augue.",3,5,"positive",22,21,3,9,9,4,4,"Market Value","Decreased",8,9,2,8,5,0,-7,4,-1.5
"262",54,2,"Malesuada sagittis duis suscipit nulla phasellus vitae. Orci lectus eu luctus.","Dolorem leo! Eros ipsum quam, fringilla rhoncus praesent, eleifend aliquet diam. Vulputate etiam nullam.",3,4,"positive",22,22,8,1,1,8,5.33333333333333,"Market Value","Decreased",5,4,1,8,-3,3,0,0,0
"263",55,1,"Lacus iaculis. Dictumst nibh imperdiet sollicitudin? Vehicula vulputate. Accusamus ab sem quis turpis. Nonummy fusce.","Luctus eleifend elementum platea risus, aliquam? Curabitur non tempus. Pellentesque.",4,5,"positive",21,21,7,9,7,2,5,"Market Value","Decreased",2,1,9,3,-5,-8,2,1,1.5
"264",56,4,"Urna pretium fermentum ipsum. Potenti potenti risus dictumst nonummy turpis fusce massa montes convallis sapien.","Euismod blandit imperdiet dui. Rutrum metus magnis vulputate ipsum phasellus at iaculis blandit.",1,7,"positive",21,21,4,5,8,2,3,"Market Value","Decreased",8,8,9,1,4,3,1,-1,0
"265",70,1,"Metus. Morbi? Etiam vivamus tincidunt purus aliquet? Maecenas erat pede mi, scelerisque.","Sem. Ultrices magnis. Gravida eu aliquam magna egestas dui massa. Accumsan egestas eros dapibus! Fusce.",1,5,"positive",22,22,5,9,6,6,6.66666666666667,"Market Value","Decreased",2,6,1,1,-3,-3,-5,-5,-5
"266",96,1,"Sollicitudin, laoreet interdum et sagittis mattis diam ante turpis ut, lorem ridiculus.","Temporibus donec mi mi. Fringilla blandit? Placerat turpis? Orci wisi urna dapibus convallis.",1,7,"positive",22,21,6,3,6,9,4,"Market Value","Decreased",9,3,2,1,3,0,-4,-8,-6
"267",1,1,"Platea praesent commodo elementum. Placerat? Consectetuer blandit consequat malesuada. Enim primis at.","Viverra vel ab facilisis ullamcorper facilisi placerat. Natoque convallis justo.",5,6,"positive",21,22,5,5,8,6,5,"Market Value","Decreased",8,1,8,8,3,-4,0,2,1
"268",5,1,"Curabitur neque mi scelerisque tempor ipsum quam faucibus tempora bibendum at tortor.","Natoque placerat velit cras primis in primis enim placerat dolorem sodales a! Elementum dictumst dolorem.",5,2,"positive",22,21,4,5,9,1,2.33333333333333,"Market Value","Decreased",7,9,2,2,3,4,-7,1,-3
"269",32,1,"Rhoncus praesent imperdiet nec ut rutrum nibh eleifend dignissim lacus.","Ab nonummy aenean quis neque at. Facilisi. Accusamus donec tempor eu phasellus elit tempor purus.",2,3,"positive",21,22,2,3,4,7,2.33333333333333,"Market Value","Decreased",2,7,2,5,0,4,-2,-2,-2
"270",98,4,"Molestie suscipit tempus molestie malesuada suspendisse dapibus ab molestie tortor tempus. Facilisis nec.","Wisi elit convallis? Placerat a. Montes sem. Fermentum sit pede elit.",1,4,"positive",22,21,2,4,1,4,1.66666666666667,"Market Value","Decreased",8,3,7,6,6,-1,6,2,4
"271",83,1,"Suspendisse a est vivamus molestie pharetra euismod massa culpa interdum donec suscipit bibendum.","Facilisi tellus laoreet temporibus lacus placerat laoreet. Quam! Tempor pede.",5,2,"positive",22,21,8,9,3,2,3.33333333333333,"Market Value","Decreased",6,8,7,6,-2,-1,4,4,4
"272",7,2,"Rhoncus per! Vestibulum dictumst platea dolorem non vitae sapien euismod sit aenean? Malesuada etiam nullam.","Dapibus atque fusce mattis montes amet diam eu integer mi.",3,2,"positive",22,22,2,3,3,1,4.33333333333333,"Market Value","Decreased",4,8,7,2,2,5,4,1,2.5
"273",65,2,"Suscipit aenean suscipit. Vehicula tempora suspendisse. Metus! Ac malesuada potenti. Suscipit.","Curabitur erat tempor luctus dictumst, aenean cras fusce. Auctor commodo.",6,2,"positive",22,22,7,1,9,8,8,"Market Value","Decreased",8,9,6,3,1,8,-3,-5,-4
"274",8,3,"Mauris pede urna vivamus massa sed tellus. Ullamcorper rutrum, consequat! Malesuada ridiculus.","Temporibus faucibus dapibus vehicula eros placerat. Eu potenti velit dictumst.",4,2,"positive",22,21,9,3,5,8,6.33333333333333,"Market Value","Decreased",5,7,2,1,-4,4,-3,-7,-5
"275",95,2,"Nullam sagittis cras ac nec a ipsum lacus, dictumst orci nulla nibh lectus leo.","Velit, rutrum fringilla natoque? Quam. Scelerisque, facilisi. Venenatis fermentum! Nullam, euismod.",3,7,"positive",22,22,6,6,4,7,5.66666666666667,"Market Value","Decreased",2,6,6,8,-4,0,2,1,1.5
"276",7,3,"Accumsan pretium? Ultrices ligula tempora. Gravida sapien tincidunt. Imperdiet ac.","Non lorem dolorem in pede accusamus interdum neque nullam. Imperdiet velit aenean.",6,3,"positive",22,22,8,5,1,3,4.66666666666667,"Market Value","Decreased",4,9,3,6,-4,4,2,3,2.5
"277",48,1,"Dignissim, euismod ridiculus tempor rutrum aliquet erat natoque proin imperdiet natoque. Et accumsan venenatis rhoncus.","Id potenti est eleifend. Integer fermentum. Sollicitudin. Curabitur vel eget.",6,6,"positive",22,22,2,6,7,5,8.33333333333333,"Market Value","Decreased",2,9,1,3,0,3,-6,-2,-4
"278",70,3,"Dolor. Vel platea at! Dolorem placerat dapibus? Eu dui eu diam montes, enim nunc.","Non? Eu. Dictumst viverra tincidunt eleifend auctor tempora, iaculis enim non ac sodales et.",4,2,"positive",21,21,8,2,4,5,6.33333333333333,"Market Value","Decreased",6,4,4,2,-2,2,0,-3,-1.5
"279",4,1,"Nunc maecenas proin vestibulum, curabitur wisi egestas suspendisse tincidunt morbi, integer malesuada sagittis scelerisque.","Nibh, porta vehicula cursus aenean erat etiam bibendum erat leo ac.",2,4,"positive",22,22,5,1,7,7,4.66666666666667,"Market Value","Decreased",6,6,4,9,1,5,-3,2,-0.5
"280",67,4,"Maecenas! Iaculis facilisi dolorem pharetra vel tincidunt quis. Tempora nulla ante neque viverra aenean.","Convallis natoque pellentesque. Fusce suspendisse? Commodo ut metus iaculis accumsan porttitor dictumst.",2,3,"positive",22,22,8,9,7,1,4,"Market Value","Decreased",8,3,4,4,0,-6,-3,3,0
"281",88,4,"Nunc fusce. Mattis? Imperdiet suscipit vulputate rutrum volutpat! Vestibulum? Magna culpa malesuada.","Nullam? Elit! Justo non et nec convallis eleifend! Lorem faucibus nibh ac.",5,2,"positive",22,21,1,5,3,6,3.33333333333333,"Market Value","Decreased",7,5,4,3,6,0,1,-3,-1
"282",84,4,"Justo commodo in ac nullam purus dapibus enim orci mauris.","Accumsan felis natoque accusamus orci. Magnis nibh justo sem. Purus.",5,5,"positive",21,21,9,3,9,5,2,"Market Value","Decreased",2,4,4,3,-7,1,-5,-2,-3.5
"283",10,2,"Facilisis ultricies rutrum? Auctor tellus per. Aliquam tempor molestie sit gravida placerat vivamus malesuada tellus.","Metus integer est vitae? Nec nunc. Vel natoque donec! Pellentesque, ultrices metus nullam, eu.",3,6,"positive",21,21,2,6,2,3,4.33333333333333,"Market Value","Decreased",8,8,3,2,6,2,1,-1,0
"284",72,3,"Imperdiet, tempus elit eros fusce urna blandit neque porta mattis praesent diam.","Malesuada tempora lectus? Consequat, blandit curabitur purus tellus eget non suspendisse.",6,6,"positive",21,21,4,7,9,9,3.66666666666667,"Market Value","Decreased",8,3,8,3,4,-4,-1,-6,-3.5
"285",53,2,"Aenean tempor sem felis ridiculus pretium orci cursus convallis. Morbi posuere ullamcorper tellus.","Cursus est? Dolorem? Suscipit per tellus potenti luctus fusce duis ac in ab.",3,4,"positive",21,21,4,5,4,2,2.66666666666667,"Market Value","Decreased",8,9,9,1,4,4,5,-1,2
"286",93,2,"Accumsan lorem? Suscipit accusamus orci augue suscipit sit culpa blandit wisi ante vulputate.","Integer massa! Turpis! Eleifend ligula. Purus sagittis maecenas. Nibh convallis eros iaculis bibendum atque. Ultrices.",2,3,"positive",21,22,7,5,1,9,6.33333333333333,"Market Value","Decreased",3,5,4,6,-4,0,3,-3,0
"287",90,4,"Et velit mauris ultricies fermentum? Wisi ullamcorper ligula, ac! Erat. Maecenas felis, ut.","Sollicitudin laoreet bibendum a? Culpa per volutpat neque phasellus pretium proin in convallis montes.",5,7,"positive",22,21,9,3,6,8,8.66666666666667,"Market Value","Decreased",7,9,9,7,-2,6,3,-1,1
"288",22,1,"Primis phasellus aliquam, eu lorem eros nulla aliquam nunc proin ligula tortor wisi.","Erat lorem ipsum felis accusamus interdum montes porttitor, enim id. Atque. Massa.",1,4,"positive",22,22,4,4,4,5,4.66666666666667,"Market Value","Decreased",3,1,2,8,-1,-3,-2,3,0.5
"289",95,2,"Donec arcu sagittis convallis? Massa. Imperdiet, accumsan facilisis consequat est maecenas facilisi erat.","Natoque porta mauris at viverra. Velit. Facilisis at accumsan accusamus.",3,4,"positive",22,22,7,4,9,3,6.66666666666667,"Market Value","Decreased",6,3,2,9,-1,-1,-7,6,-0.5
"290",20,3,"Mauris fringilla vel temporibus elementum odio eleifend. Vel culpa fringilla vulputate eget lorem ante.","Nulla, tellus dictumst! Nulla. Elit vehicula massa dolor augue tempora.",2,5,"positive",21,21,9,3,2,9,3.66666666666667,"Market Value","Decreased",7,7,7,8,-2,4,5,-1,2
"291",98,4,"Sit? Placerat ligula, porta tempora nec justo lacus diam nulla.","Auctor leo. Temporibus. Leo facilisi praesent, pellentesque sapien sapien sapien consequat pretium tempus.",3,2,"positive",21,21,9,9,1,5,4,"Market Value","Decreased",9,4,8,6,0,-5,7,1,4
"292",60,2,"Nullam interdum pellentesque ab non et vulputate? Pretium. Praesent in malesuada.","Aliquet tempora ullamcorper diam turpis potenti tortor fermentum tincidunt mi ab. Nibh! Duis.",4,1,"positive",22,21,4,4,4,3,3.33333333333333,"Market Value","Decreased",5,4,4,3,1,0,0,0,0
"293",20,1,"Luctus? Felis diam risus elementum vel consequat elit placerat. Donec accumsan.","Vehicula nullam convallis id praesent neque nunc non eget ridiculus aliquam ultrices orci.",6,4,"positive",21,21,5,3,4,6,5.33333333333333,"Market Value","Decreased",8,5,4,7,3,2,0,1,0.5
"294",43,2,"Vestibulum pretium. Mattis lectus dictumst fermentum commodo. Interdum augue et natoque iaculis.","Vehicula. Et aliquet! Pede duis pede nullam fusce bibendum aliquet ridiculus facilisi ligula.",6,4,"positive",22,22,4,2,1,6,3.66666666666667,"Market Value","Decreased",4,2,3,9,0,0,2,3,2.5
"295",32,2,"Tempus euismod tempus tempus facilisi diam lacus est metus. Amet.","Diam eleifend phasellus malesuada justo. Magnis elit fermentum? Porttitor. Quam rhoncus ultricies cursus lacus! Diam.",4,7,"positive",21,21,1,8,7,1,6,"Market Value","Decreased",2,7,3,5,1,-1,-4,4,0
"296",71,2,"Nonummy dolor morbi pellentesque tempus rutrum consectetuer faucibus magnis mattis. Ipsum.","Quis egestas molestie. Imperdiet odio luctus tincidunt nonummy orci ridiculus elit! Duis.",1,5,"positive",22,22,2,8,7,3,5,"Market Value","Decreased",4,9,4,4,2,1,-3,1,-1
"297",84,2,"Proin accumsan amet tempor. Accusamus fusce iaculis dui? Sagittis auctor ac donec magna vel arcu.","Iaculis, metus a? Atque platea egestas justo dui quam temporibus et. Dictumst auctor et.",5,7,"positive",21,21,3,9,8,4,4.33333333333333,"Market Value","Decreased",6,6,1,8,3,-3,-7,4,-1.5
"298",20,4,"Leo venenatis magna orci phasellus nunc placerat fermentum et! Culpa.","Gravida? Vulputate amet placerat elit molestie cras massa faucibus donec consequat ipsum ligula.",2,2,"positive",22,21,5,8,3,8,1.66666666666667,"Market Value","Decreased",4,9,8,2,-1,1,5,-6,-0.5
"299",30,4,"Dolor nec? Primis. Pharetra vehicula accusamus nonummy aliquet quam! Curabitur arcu.","Integer? Nullam, montes rutrum, id nunc euismod cras auctor imperdiet ut.",4,4,"positive",21,21,1,8,5,6,6,"Market Value","Decreased",3,8,8,3,2,0,3,-3,0
"300",75,3,"Pretium montes ullamcorper convallis ac sem sagittis nonummy molestie quam lectus.","Donec neque dapibus neque sed eros aenean leo. Accusamus ipsum tortor posuere.",1,1,"positive",21,21,2,5,1,6,5.33333333333333,"Market Value","Decreased",7,7,7,3,5,2,6,-3,1.5
"301",7,1,"Elementum diam aenean? Quis? Fermentum wisi pretium magna accusamus vivamus blandit consectetuer. Sed.","Lacus eget. Gravida? Sem pretium sed faucibus augue urna ab scelerisque maecenas ultricies arcu.",6,1,"positive",21,21,4,6,1,1,7,"Market Value","Decreased",6,2,3,6,2,-4,2,5,3.5
"302",54,2,"Facilisis. Lorem. Elementum, sit arcu magnis scelerisque. Ultricies ullamcorper porttitor cursus phasellus ullamcorper sapien.","Elementum augue arcu lorem, etiam mattis. Sed venenatis ultricies eu. Tortor bibendum sed ipsum massa.",3,7,"positive",21,21,8,9,2,6,3.33333333333333,"Market Value","Decreased",8,5,4,5,0,-4,2,-1,0.5
"303",18,2,"Consequat turpis, ab per in. Augue? Sit vel wisi. Rutrum vehicula odio magnis accumsan.","Nunc sed. Ante nonummy phasellus porta porttitor arcu potenti tempus primis neque.",6,2,"positive",22,21,1,6,5,8,6.33333333333333,"Market Value","Decreased",2,9,6,4,1,3,1,-4,-1.5
"304",67,2,"Consectetuer pretium, potenti egestas rhoncus sed tempor facilisis egestas nec.","Augue. Blandit iaculis. Ipsum. Sagittis eu sit! Quis nibh eu egestas.",6,6,"positive",22,21,3,8,1,1,5.66666666666667,"Market Value","Decreased",7,5,4,7,4,-3,3,6,4.5
"305",25,3,"Neque justo culpa! Duis sodales viverra! Vivamus leo nulla metus! Sollicitudin est nunc neque? Fusce.","Sagittis commodo? Posuere magna consectetuer cursus facilisis orci ac tempor.",5,1,"positive",21,22,4,6,1,5,5,"Market Value","Decreased",8,7,1,1,4,1,0,-4,-2
"306",92,4,"Venenatis nullam proin. Vel consequat ut urna, vitae odio auctor eleifend potenti? Mi.","Ipsum purus posuere integer pellentesque gravida ac. Duis porttitor dolorem integer ac.",3,4,"positive",21,22,5,1,1,8,7.33333333333333,"Market Value","Decreased",1,7,6,9,-4,6,5,1,3
"307",36,4,"Tincidunt ante integer fringilla purus? Tempus. Commodo temporibus quis eros.","Nulla venenatis purus eros eleifend vestibulum vulputate. Sit sem facilisis neque laoreet velit praesent.",3,3,"positive",21,21,9,8,6,9,6.33333333333333,"Market Value","Decreased",2,6,5,2,-7,-2,-1,-7,-4
"308",27,2,"Dictumst enim malesuada accumsan urna eu. Imperdiet imperdiet? Erat ac enim purus urna pretium.","Auctor sapien consequat fermentum. Egestas accumsan wisi euismod sapien elit eros.",2,7,"positive",22,21,1,4,1,6,3.66666666666667,"Market Value","Decreased",9,5,5,5,8,1,4,-1,1.5
"309",74,2,"Praesent vulputate ac pellentesque non laoreet lacus massa. Nullam temporibus.","Urna. Fusce pretium! Maecenas est? Facilisis gravida tempor nibh. Accumsan wisi ultricies convallis! Ligula, sed.",4,5,"positive",22,21,6,6,2,7,3.66666666666667,"Market Value","Decreased",9,9,8,3,3,3,6,-4,1
"310",80,3,"Leo dolorem phasellus luctus, ac? Viverra vitae culpa! Volutpat nulla.","Maecenas! Dolorem blandit accumsan! Egestas fringilla metus montes vitae ipsum placerat.",1,7,"positive",22,21,6,5,3,1,2.33333333333333,"Market Value","Decreased",3,3,5,1,-3,-2,2,0,1
"311",8,1,"Fusce ligula natoque dui integer commodo eget dignissim wisi tortor ultricies viverra neque.","Ligula. Sagittis justo pede vestibulum per potenti aliquet neque mauris sed. Orci, accusamus.",3,4,"positive",22,21,5,9,2,5,8,"Market Value","Decreased",7,6,7,6,2,-3,5,1,3
"312",36,1,"Id tortor ipsum ligula eget vehicula ante metus eget duis gravida praesent nunc.","Accumsan ligula mauris quam laoreet in, vestibulum vestibulum risus posuere! Dui proin ante? Placerat.",2,1,"positive",22,21,4,3,4,2,4,"Market Value","Decreased",3,9,5,5,-1,6,1,3,2
"313",85,4,"Suspendisse iaculis porttitor! Consectetuer etiam ultricies luctus tellus cursus, mattis molestie.","Etiam pretium velit velit nulla malesuada vivamus viverra venenatis imperdiet malesuada.",6,4,"positive",22,22,8,6,5,2,1,"Market Value","Decreased",6,6,1,7,-2,0,-4,5,0.5
"314",1,2,"Enim vivamus per gravida, suspendisse faucibus! Sollicitudin purus vitae. Ut.","Dolor dui vehicula vitae ac posuere. Facilisis, molestie venenatis at.",2,7,"positive",21,21,5,7,4,9,4.66666666666667,"Market Value","Decreased",7,3,3,2,2,-4,-1,-7,-4
"315",93,3,"Tempus. Aliquam. Lacus wisi eu placerat? Sollicitudin fringilla accusamus magnis.","Turpis donec praesent consequat ultrices. Eget viverra felis odio a.",1,5,"positive",22,22,6,4,7,4,4,"Market Value","Decreased",9,4,6,5,3,0,-1,1,0
"316",3,3,"Lorem magnis augue. Aliquam culpa, ultricies morbi pede laoreet potenti a.","Ante enim posuere? Facilisi eu! At! Viverra euismod ultricies? Eget vehicula iaculis.",6,5,"positive",21,21,9,9,4,7,4,"Market Value","Decreased",8,4,5,1,-1,-5,1,-6,-2.5
"317",75,4,"Velit! Urna consequat phasellus. Tellus lacus sagittis arcu nibh diam aliquam vel bibendum.","Fermentum ridiculus mauris vel tellus auctor tincidunt ante ultricies amet non posuere! Suspendisse. Cras.",4,5,"positive",22,22,2,4,1,8,5,"Market Value","Decreased",1,7,6,9,-1,3,5,1,3
"318",55,4,"Arcu? Rhoncus, sodales! Malesuada blandit eleifend vulputate turpis? Quis platea neque metus.","Nonummy bibendum! Maecenas sodales pellentesque mi. Turpis vivamus rutrum temporibus rhoncus suscipit praesent tempora lorem.",5,4,"positive",22,21,8,2,3,4,4.33333333333333,"Market Value","Decreased",3,6,2,3,-5,4,-1,-1,-1
"319",76,1,"Scelerisque augue felis. Ac magnis sem pede erat ridiculus. Natoque.","Ultricies. Ac rhoncus, bibendum et! Iaculis, faucibus neque ultrices turpis venenatis.",4,4,"positive",21,22,6,4,5,1,5.66666666666667,"Market Value","Decreased",9,5,1,3,3,1,-4,2,-1
"320",43,2,"Nunc quis vestibulum commodo. Dignissim proin placerat. Eleifend. Culpa, blandit dolorem augue vestibulum.","Non lectus fermentum temporibus posuere rutrum est vulputate, tempus orci scelerisque malesuada aliquam nunc. Per.",6,3,"positive",22,22,7,8,7,8,1.66666666666667,"Market Value","Decreased",6,8,1,3,-1,0,-6,-5,-5.5
"321",84,3,"Suspendisse vel lectus eleifend integer commodo augue volutpat turpis phasellus.","Aenean platea? Curabitur egestas accusamus aenean. Porta duis rhoncus vivamus interdum fusce ligula. Eleifend.",4,4,"negative",22,21,2,4,5,5,5.33333333333333,"Contagion","Highlighted",8,1,1,5,6,-3,-4,0,-2
"322",46,4,"Pede sodales dignissim montes tempora risus ab dui, porttitor, risus.","Nonummy fringilla. Quis nullam fermentum. Turpis mattis vitae a platea facilisi vivamus.",6,1,"negative",22,21,2,3,3,9,6.33333333333333,"Contagion","Highlighted",4,8,4,7,2,5,1,-2,-0.5
"323",52,3,"Accusamus etiam! Molestie velit enim malesuada eleifend a nullam massa lacus.","Praesent accumsan mauris per lorem neque malesuada montes, augue a. Euismod.",3,1,"negative",22,22,4,9,5,8,6.66666666666667,"Contagion","Highlighted",3,2,1,9,-1,-7,-4,1,-1.5
"324",83,4,"In urna iaculis! Orci dictumst eu aliquam at. Magna justo duis.","Ultrices tortor? Tempora elementum, enim massa dignissim bibendum ac! Non.",3,5,"negative",21,22,7,1,4,1,6.66666666666667,"Contagion","Highlighted",3,9,3,4,-4,8,-1,3,1
"325",29,3,"Et tellus potenti curabitur, est. Egestas fringilla dui ultrices sagittis consequat temporibus. Fermentum scelerisque.","Commodo eget vel, phasellus luctus! In porttitor! Vulputate. Gravida nulla sagittis sollicitudin.",4,1,"negative",21,22,7,9,5,3,5,"Contagion","Highlighted",3,3,8,7,-4,-6,3,4,3.5
"326",80,3,"Eros donec scelerisque massa sagittis nullam ante odio suscipit nec ridiculus.","Nulla rhoncus tempus! Ultrices! Vulputate faucibus! Sed nonummy ab sed justo wisi enim. Bibendum.",2,5,"negative",22,21,8,2,2,6,4.33333333333333,"Contagion","Highlighted",1,2,9,2,-7,0,7,-4,1.5
"327",32,4,"Morbi accumsan tempus ligula curabitur elit sagittis etiam et amet! Nunc magna. Pede justo.","Integer ab, sagittis tempora mi. Eget cursus odio fringilla mauris accusamus.",4,6,"negative",21,22,5,2,9,1,3.33333333333333,"Contagion","Highlighted",4,4,4,1,-1,2,-5,0,-2.5
"328",8,4,"Magnis cursus ultrices erat dui. Dapibus. Eros justo a egestas.","Euismod tellus tortor? Posuere malesuada faucibus. Diam tempus primis velit auctor.",6,3,"negative",22,22,5,7,5,6,7,"Contagion","Highlighted",8,3,7,1,3,-4,2,-5,-1.5
"329",75,4,"Montes platea eros, fringilla leo non a. Malesuada accumsan ipsum scelerisque vitae atque mauris. Lectus.","Ridiculus porttitor morbi! Ridiculus faucibus venenatis interdum mi felis cursus. Bibendum ullamcorper vulputate lacus.",3,3,"negative",22,21,9,8,5,9,3,"Contagion","Highlighted",4,7,2,6,-5,-1,-3,-3,-3
"330",78,1,"Porttitor urna vehicula mauris mauris risus dui, velit. Natoque euismod. Tempus vulputate.","Pellentesque pellentesque aliquet enim, pretium sagittis! Erat scelerisque porta imperdiet.",2,6,"negative",22,22,2,9,7,6,5.33333333333333,"Contagion","Highlighted",3,3,5,7,1,-6,-2,1,-0.5
"331",48,4,"Interdum nulla. Faucibus lorem, ab risus lacus magna est, suspendisse rutrum temporibus.","Ipsum egestas dolor, interdum vel magnis proin potenti porttitor metus curabitur sagittis ultrices.",3,3,"negative",21,21,8,4,9,8,8,"Contagion","Highlighted",7,6,8,4,-1,2,-1,-4,-2.5
"332",63,1,"Blandit turpis malesuada placerat consectetuer magna. Mauris tempora facilisis? Porta phasellus pellentesque.","Platea nonummy potenti integer urna lacus consequat orci! Nibh cursus tellus lectus maecenas sem viverra.",3,5,"negative",21,21,8,7,4,5,4.33333333333333,"Contagion","Highlighted",8,5,2,7,0,-2,-2,2,0
"333",34,3,"Justo gravida id? Eleifend ultrices porttitor id pretium? Metus! Facilisis nonummy.","Praesent? Interdum mauris fusce tempora orci magna. Mi praesent molestie dolorem ut accusamus.",5,3,"negative",22,22,3,3,5,6,5.66666666666667,"Contagion","Highlighted",7,4,5,9,4,1,0,3,1.5
"334",32,2,"Platea in, lacus donec elementum tellus porta egestas sollicitudin accusamus.","Laoreet wisi felis lorem massa facilisi gravida malesuada etiam nonummy duis a eros viverra mattis.",3,6,"negative",22,22,7,6,7,5,6.66666666666667,"Contagion","Highlighted",8,2,9,4,1,-4,2,-1,0.5
"335",12,4,"Nulla natoque, nulla potenti tempor magnis? Enim amet phasellus consequat dignissim fringilla volutpat. Quam phasellus.","Sapien massa accusamus fusce phasellus augue posuere purus malesuada egestas.",6,6,"negative",21,22,7,9,5,5,2.66666666666667,"Contagion","Highlighted",9,3,1,2,2,-6,-4,-3,-3.5
"336",94,4,"Consectetuer at. Eros diam sodales sed? Nunc sodales eget quis metus.","Pretium leo praesent. Lectus dolorem consequat facilisi luctus porta turpis vestibulum laoreet.",6,2,"negative",22,22,7,8,1,1,5,"Contagion","Highlighted",6,5,4,2,-1,-3,3,1,2
"337",66,3,"Potenti massa praesent et erat curabitur consectetuer proin praesent, pharetra erat aenean. Nullam etiam.","Pretium, aliquet molestie sed ligula sodales cursus urna tincidunt mi leo purus nunc. Sollicitudin accumsan.",3,7,"negative",21,22,3,8,3,1,4.33333333333333,"Contagion","Highlighted",7,9,1,4,4,1,-2,3,0.5
"338",28,3,"Quam euismod primis auctor. Facilisi risus facilisi. Eleifend nulla eget pede? Atque vulputate turpis.","Lectus. Quam? Imperdiet fringilla. Wisi mattis vitae erat ultrices! Rhoncus integer. Mattis.",6,5,"negative",21,22,5,4,1,9,4,"Contagion","Highlighted",7,8,9,8,2,4,8,-1,3.5
"339",12,2,"Vel natoque? Diam sit? Quis temporibus at donec curabitur? Euismod eget lectus? Urna.","Arcu pretium pharetra ac per! Malesuada mauris interdum aenean imperdiet natoque aliquet facilisi sollicitudin proin.",2,1,"negative",21,21,1,7,6,9,3.66666666666667,"Contagion","Highlighted",9,1,5,6,8,-6,-1,-3,-2
"340",14,4,"Temporibus sem vitae vestibulum aliquam donec in sodales, accumsan auctor ultricies.","Praesent. Quis maecenas ante sodales, metus pretium mi. Eros urna.",2,1,"negative",21,22,7,3,4,5,2.66666666666667,"Contagion","Highlighted",3,8,4,7,-4,5,0,2,1
"341",29,2,"Aliquam temporibus lorem dolor vestibulum eros dictumst phasellus? Risus magnis arcu sollicitudin sodales molestie.","Montes. Justo aliquam, scelerisque ridiculus cursus aliquam temporibus nec ipsum eu.",3,2,"negative",22,22,7,3,5,7,5,"Contagion","Highlighted",7,1,3,8,0,-2,-2,1,-0.5
"342",44,2,"Lorem accusamus etiam risus tempor magnis tempus integer egestas augue vitae enim ullamcorper massa potenti.","Ligula donec dolorem amet rutrum! Ab. Ullamcorper tellus suscipit pretium, lacus orci.",6,7,"negative",22,22,9,7,4,5,6,"Contagion","Highlighted",9,7,3,6,0,0,-1,1,0
"343",32,1,"Nonummy ante elementum pellentesque pellentesque ut quis pede porta auctor.","Mattis montes pellentesque! Dictumst fermentum ultricies! Tellus blandit! Eros euismod et.",5,2,"negative",21,22,7,1,4,3,3,"Contagion","Highlighted",8,3,9,6,1,2,5,3,4
"344",23,4,"Iaculis sagittis scelerisque phasellus laoreet vehicula. Tincidunt auctor faucibus culpa erat tempus. Primis turpis.","Eleifend vitae, posuere vel eros. Vulputate cursus nec potenti! Risus. Est placerat.",6,5,"negative",22,21,1,4,4,7,5,"Contagion","Highlighted",4,8,7,7,3,4,3,0,1.5
"345",83,4,"Odio pede? Porta ac per! Fermentum arcu bibendum mauris felis primis.","Ipsum imperdiet rutrum etiam per pede eu felis scelerisque? Massa nec.",3,7,"negative",22,22,7,8,4,1,6,"Contagion","Highlighted",8,8,5,8,1,0,1,7,4
"346",23,3,"Lorem orci massa phasellus fusce elit facilisi purus urna blandit. Est fringilla? Justo. Suscipit.","Ridiculus? Velit. Leo sit, sed justo turpis eleifend. Massa, iaculis montes non mauris.",1,2,"negative",22,21,4,4,5,4,1.66666666666667,"Contagion","Highlighted",4,7,7,7,0,3,2,3,2.5
"347",20,2,"Ligula rutrum vulputate dignissim blandit potenti ultrices aenean scelerisque! Gravida accusamus.","Nunc aliquet egestas rhoncus egestas suscipit. Proin interdum proin tempor at vestibulum luctus duis aliquet.",6,1,"negative",21,22,1,6,3,9,3.33333333333333,"Contagion","Highlighted",8,8,8,7,7,2,5,-2,1.5
"348",93,1,"Nullam suspendisse. Odio, iaculis tincidunt tempora malesuada pellentesque? Culpa! A bibendum.","Magna velit donec! Convallis imperdiet pede egestas. Morbi sem! Vitae luctus euismod.",3,4,"negative",22,22,1,8,6,7,3.66666666666667,"Contagion","Highlighted",5,9,3,2,4,1,-3,-5,-4
"349",16,1,"Odio tincidunt scelerisque! Orci luctus ultricies scelerisque curabitur morbi viverra aenean praesent.","Non placerat pharetra quis temporibus ultricies purus. Quis nec massa pede montes.",6,2,"negative",21,21,7,1,6,5,6.66666666666667,"Contagion","Highlighted",4,9,4,8,-3,8,-2,3,0.5
"350",49,1,"Donec? Donec turpis tortor laoreet maecenas. Leo proin vestibulum sed.","Accusamus? Ut. Atque rhoncus velit quis dignissim euismod? Risus egestas faucibus.",5,5,"negative",22,21,9,4,6,9,4.33333333333333,"Contagion","Highlighted",6,2,3,8,-3,-2,-3,-1,-2
"351",59,1,"Facilisis pellentesque. Nibh consectetuer rutrum platea malesuada. Lacus. Diam posuere nulla viverra.","Euismod! Rhoncus ac sapien. Duis, odio purus sem mi accusamus, dolorem suscipit augue.",1,7,"negative",22,21,2,9,6,3,8.33333333333333,"Contagion","Highlighted",5,8,6,3,3,-1,0,0,0
"352",5,1,"Lacus quam ante tincidunt primis! Faucibus morbi cras aliquet suspendisse bibendum rutrum iaculis dolorem.","Dolor vivamus, integer. Justo duis aliquet. Quam magna nonummy dui. Bibendum. In quam vitae curabitur.",1,7,"negative",21,21,7,8,7,8,4.33333333333333,"Contagion","Highlighted",4,8,1,6,-3,0,-6,-2,-4
"353",86,4,"Sit? Scelerisque cras neque gravida curabitur! Nullam facilisis sagittis ullamcorper morbi vulputate.","Magnis pretium ipsum nibh vitae. Nonummy felis mi lacus odio amet ultrices.",5,7,"negative",22,21,4,5,3,4,4.66666666666667,"Contagion","Highlighted",8,2,8,3,4,-3,5,-1,2
"354",32,2,"Felis imperdiet suspendisse sollicitudin. Ligula in augue commodo vehicula eleifend elementum potenti.","In lectus nullam nulla ut tincidunt wisi maecenas! Ac arcu velit luctus primis amet pretium.",1,6,"negative",21,21,8,3,6,5,3,"Contagion","Highlighted",9,9,4,8,1,6,-2,3,0.5
"355",60,4,"Sollicitudin natoque primis lectus natoque erat mattis dignissim imperdiet dui? Dolorem.","Posuere amet tellus et! Magnis! Viverra dolor cras diam magna molestie iaculis blandit eget.",3,2,"negative",22,21,2,6,6,9,6,"Contagion","Highlighted",2,7,3,2,0,1,-3,-7,-5
"356",92,1,"Mauris. Etiam montes et consectetuer justo, molestie wisi platea aliquet. Felis.","Urna est? Vitae molestie facilisi rutrum, facilisis. Facilisis porta porta eget dolor nibh. Pellentesque.",5,1,"negative",22,22,3,3,8,7,7,"Contagion","Highlighted",9,6,4,9,6,3,-4,2,-1
"357",82,2,"In! Mi enim? Risus magnis, dolorem dolor bibendum duis aliquam? Fringilla! Ut.","Curabitur gravida vivamus gravida elementum porttitor tortor. Nullam platea primis eu aenean! Dictumst euismod.",2,6,"negative",21,21,3,3,7,4,5.66666666666667,"Contagion","Highlighted",6,8,4,1,3,5,-3,-3,-3
"358",40,1,"Lacus. Lacus integer porttitor porta. Elit blandit aenean. Turpis convallis bibendum.","Porttitor. Vivamus sollicitudin lacus proin dolorem ipsum consequat etiam euismod, rhoncus ante ac.",3,3,"negative",22,21,8,6,3,6,7.33333333333333,"Contagion","Highlighted",9,9,3,1,1,3,0,-5,-2.5
"359",87,3,"Maecenas. Pharetra posuere eget duis faucibus faucibus ab facilisis, justo.","Aenean bibendum bibendum vehicula vitae? Non interdum suspendisse ullamcorper euismod. Faucibus felis.",4,6,"negative",21,22,9,1,8,8,7,"Contagion","Highlighted",3,3,1,1,-6,2,-7,-7,-7
"360",6,2,"Gravida mauris? Ridiculus vel? Sit atque primis, tincidunt sit ipsum elit quam.","Mattis elit amet maecenas nunc ridiculus primis eros, platea dolor faucibus proin rutrum. Euismod tortor.",4,2,"negative",22,22,4,4,6,2,4.66666666666667,"Contagion","Highlighted",4,5,3,7,0,1,-3,5,1
"361",6,2,"Pretium eros! Phasellus per ullamcorper. Odio vel, vehicula. Euismod orci est sollicitudin? Suspendisse accumsan.","Tempus! Rutrum elementum in bibendum. Arcu! Ac atque? Duis dolorem magnis platea accumsan.",1,5,"negative",22,21,1,1,3,9,4.66666666666667,"Contagion","Highlighted",4,2,1,8,3,1,-2,-1,-1.5
"362",14,4,"Magna elementum metus morbi quis ipsum ullamcorper vestibulum donec eget.","Enim bibendum ultrices est. Dolor aenean, id? Id cursus, odio.",5,4,"negative",22,21,6,9,9,2,9,"Contagion","Highlighted",3,9,2,6,-3,0,-7,4,-1.5
"363",36,1,"Dui arcu suspendisse morbi cras! Per pretium posuere! Consectetuer egestas maecenas bibendum nonummy ligula.","Fermentum eleifend ante quam vestibulum dictumst ullamcorper! Ab magna tellus turpis sem.",3,7,"negative",21,22,8,2,6,7,3,"Contagion","Highlighted",6,7,8,2,-2,5,2,-5,-1.5
"364",40,3,"Viverra natoque sodales ligula eros. Magnis! Ultricies placerat laoreet risus sit! Leo.","Proin. Duis! Posuere natoque vehicula nullam purus praesent potenti justo gravida, a primis fringilla.",3,6,"negative",21,22,1,2,1,5,2,"Contagion","Highlighted",2,6,8,5,1,4,7,0,3.5
"365",81,4,"Urna mattis enim amet fringilla! Consectetuer pharetra pellentesque pretium ipsum, vulputate? Ac.","Porttitor imperdiet nibh! Lorem sem donec placerat euismod neque phasellus? Tortor.",2,3,"negative",22,22,4,8,9,5,4.66666666666667,"Contagion","Highlighted",3,6,5,6,-1,-2,-4,1,-1.5
"366",58,4,"Leo auctor iaculis metus! Arcu! Nullam massa fusce consectetuer praesent, tellus potenti pede.","Nullam felis aliquam sagittis felis gravida ipsum neque facilisis. Arcu dolorem etiam.",1,1,"negative",21,21,3,2,9,8,4.66666666666667,"Contagion","Highlighted",3,4,5,1,0,2,-4,-7,-5.5
"367",95,1,"Tempus neque suspendisse vehicula! Dolorem duis maecenas blandit malesuada euismod eget, et dolor imperdiet tincidunt.","Ligula ullamcorper facilisis elit accumsan quam facilisi! Mi convallis donec justo. Eleifend.",2,1,"negative",22,22,1,4,6,4,3.66666666666667,"Contagion","Highlighted",5,8,2,2,4,4,-4,-2,-3
"368",14,2,"Ante cras leo tempor! Facilisi velit praesent odio est eget. Accumsan fringilla ullamcorper sodales phasellus.","Pharetra eu dui cursus. Mauris magnis, odio a iaculis at atque duis ante.",4,7,"negative",22,21,4,9,9,2,6,"Contagion","Highlighted",8,4,6,6,4,-5,-3,4,0.5
"369",81,3,"Enim eget rutrum. Temporibus vestibulum pede ac pretium diam risus.","Euismod nunc! Lorem ultricies mi pharetra ab viverra. Orci turpis. Natoque, integer quis aliquam. Donec.",3,7,"negative",22,21,5,4,7,1,6.33333333333333,"Contagion","Highlighted",6,1,2,8,1,-3,-5,7,1
"370",70,2,"Ultricies facilisi cras, diam porta est rutrum mauris non convallis vitae! Atque urna.","Sapien atque cursus dui dapibus orci! Pede purus accumsan massa.",4,7,"negative",22,21,4,6,3,7,5.33333333333333,"Contagion","Highlighted",7,9,1,8,3,3,-2,1,-0.5
"371",89,4,"Eleifend iaculis montes gravida venenatis vivamus cursus vivamus molestie lorem praesent fringilla! Mauris egestas amet.","Quis nonummy velit temporibus enim. Morbi primis vivamus amet, posuere, elementum felis.",4,5,"negative",21,22,5,2,2,3,3.33333333333333,"Contagion","Highlighted",4,8,9,1,-1,6,7,-2,2.5
"372",73,3,"Arcu vestibulum neque primis rutrum! Commodo vestibulum tempor! Dolorem. In pharetra sed fusce accusamus lorem.","Lorem accumsan arcu consequat lorem placerat luctus est non dolor! Tempora! Metus at, vivamus! Rhoncus.",6,6,"negative",22,21,2,9,5,2,4.66666666666667,"Contagion","Highlighted",1,7,8,8,-1,-2,3,6,4.5
"373",79,1,"Curabitur dolorem. Eleifend platea. Posuere morbi ab malesuada primis auctor.","Enim scelerisque! Natoque nibh turpis. Velit neque atque convallis montes. Etiam vitae fermentum commodo ab.",4,3,"negative",22,21,8,4,2,5,5.66666666666667,"Contagion","Highlighted",9,5,6,2,1,1,4,-3,0.5
"374",88,4,"Pellentesque cras cras consectetuer. Malesuada volutpat augue! Mauris? Dolor placerat proin. Id.","Magna atque pharetra aliquet cursus culpa vestibulum nunc iaculis ipsum porttitor.",6,7,"negative",22,21,2,4,6,3,6.66666666666667,"Contagion","Highlighted",5,6,2,8,3,2,-4,5,0.5
"375",51,2,"Mattis imperdiet augue? Pede pharetra? Atque elementum suscipit? Aenean a quam laoreet venenatis culpa ligula.","Enim commodo tempor neque! Tempor consectetuer scelerisque mattis aliquet? Accusamus eget erat blandit sem vestibulum.",5,2,"negative",22,21,4,7,3,8,7.33333333333333,"Contagion","Highlighted",9,5,9,4,5,-2,6,-4,1
"376",62,1,"Non consectetuer tincidunt. Ab elementum nullam interdum dictumst dolor vehicula.","Risus dapibus augue. Imperdiet ridiculus lorem, mauris, porta id! Vitae.",4,1,"negative",21,22,8,7,3,3,5,"Contagion","Highlighted",6,9,3,8,-2,2,0,5,2.5
"377",75,1,"Sollicitudin? Id sem eros vulputate porttitor fermentum tellus. Sapien euismod! Orci vel elit scelerisque. Ut.","Ridiculus imperdiet dapibus quam vulputate porta consectetuer neque mauris nibh primis bibendum risus magnis.",5,7,"negative",22,21,9,9,8,5,5.66666666666667,"Contagion","Highlighted",8,6,7,1,-1,-3,-1,-4,-2.5
"378",41,3,"Massa dui at cras turpis arcu fringilla consectetuer neque primis. Neque blandit urna pellentesque wisi.","Purus? Diam suscipit tempus tincidunt sem viverra accumsan facilisis. Platea. Diam suspendisse.",3,6,"negative",21,21,8,4,2,5,6.33333333333333,"Contagion","Highlighted",2,2,5,5,-6,-2,3,0,1.5
"379",21,3,"Ab mi tempor quam arcu vehicula consequat. Elit posuere suscipit? Porttitor phasellus mauris tempora.","Dolorem! Donec leo magnis sem atque mattis justo, sodales sodales pede consectetuer iaculis.",6,7,"negative",22,21,8,4,3,7,4.33333333333333,"Contagion","Highlighted",1,6,9,4,-7,2,6,-3,1.5
"380",48,1,"Lacus suscipit pharetra odio curabitur metus bibendum velit eget tempora nulla.","Ullamcorper amet ut duis eros lorem eu mauris quam proin.",6,4,"negative",22,21,7,7,1,3,5.66666666666667,"Contagion","Highlighted",9,4,3,4,2,-3,2,1,1.5
"381",8,1,"Mauris et nonummy ultrices atque in? Tempora curabitur non dapibus diam cras ipsum.","Sodales. Eleifend wisi vestibulum phasellus! Ipsum purus? Porttitor proin leo. Imperdiet est wisi sed elit.",6,2,"negative",21,22,2,5,4,3,5.66666666666667,"Contagion","Highlighted",6,8,1,8,4,3,-3,5,1
"382",18,3,"Maecenas! Sem risus massa? Nibh a culpa, porttitor vel! Ligula convallis natoque morbi euismod iaculis.","Maecenas purus ab nullam mauris ridiculus placerat temporibus pretium vestibulum diam. Mauris facilisis cras augue.",5,6,"negative",21,22,5,4,1,7,6.66666666666667,"Contagion","Highlighted",6,2,6,5,1,-2,5,-2,1.5
"383",70,2,"Id tempora porta massa vel. Ullamcorper ultricies dignissim nonummy cursus pede culpa luctus, rutrum.","Tortor. Nec orci! Dictumst felis. Risus porttitor commodo per mi odio natoque iaculis porta.",5,6,"negative",22,21,2,7,6,2,2.33333333333333,"Contagion","Highlighted",7,4,9,2,5,-3,3,0,1.5
"384",87,1,"Montes leo cursus scelerisque? Natoque aliquet in consectetuer tempus gravida maecenas sollicitudin pharetra est.","Pharetra malesuada, phasellus amet? Nunc metus, est proin cursus tempus rutrum praesent.",5,6,"negative",21,21,3,1,5,9,6,"Contagion","Highlighted",7,3,3,2,4,2,-2,-7,-4.5
"385",30,4,"Volutpat iaculis a id ac placerat vivamus bibendum luctus. Diam dui leo. Ultrices vivamus.","Vel? Sed fringilla felis. Justo ab? In curabitur lacus temporibus placerat placerat suspendisse dolorem.",3,4,"negative",22,21,8,3,4,3,5.33333333333333,"Contagion","Highlighted",9,8,5,6,1,5,1,3,2
"386",4,4,"Cras nulla per ullamcorper volutpat at a commodo culpa luctus tempor. Urna, natoque.","Imperdiet porta temporibus eu? Morbi orci etiam atque. Quis non.",5,5,"negative",22,21,7,7,6,6,6.33333333333333,"Contagion","Highlighted",8,9,7,4,1,2,1,-2,-0.5
"387",45,3,"Culpa atque eu neque arcu dictumst. Metus. Dignissim temporibus felis praesent! Mattis molestie vivamus.","Ultricies quam sagittis? Atque nunc in. A justo sagittis potenti metus cursus quam aliquam facilisi.",4,1,"negative",21,21,3,1,4,2,4.33333333333333,"Contagion","Highlighted",6,8,8,6,3,7,4,4,4
"388",18,1,"Vitae quam suscipit mauris natoque ligula massa vulputate. Purus posuere eros tincidunt nunc nulla.","Volutpat temporibus pharetra primis? Orci laoreet odio temporibus! Suspendisse nonummy at magnis.",6,6,"negative",22,22,3,1,8,6,7,"Contagion","Highlighted",8,6,8,9,5,5,0,3,1.5
"389",54,3,"Phasellus facilisis ac lorem facilisi! Luctus. Morbi lorem ac tincidunt. Metus dui.","Dapibus eros tempora? Amet quam posuere viverra rhoncus. Faucibus, integer.",4,7,"negative",21,21,8,3,6,6,6.66666666666667,"Contagion","Highlighted",7,9,3,6,-1,6,-3,0,-1.5
"390",21,4,"Massa ridiculus vel? Nec tellus mi? Sit massa, enim integer.","Eleifend porta fusce. Mi. Maecenas at porta arcu temporibus ultrices.",3,6,"negative",22,21,3,8,7,5,5.66666666666667,"Contagion","Highlighted",9,7,2,6,6,-1,-5,1,-2
"391",49,4,"Aliquet lacus dignissim mi posuere accusamus porta? Neque pharetra porttitor nec. Malesuada.","Fringilla! Quam vel malesuada ultricies platea massa culpa amet tempora sapien mauris. Laoreet magna.",5,7,"negative",21,21,5,1,2,3,4.66666666666667,"Contagion","Highlighted",5,5,6,8,0,4,4,5,4.5
"392",1,2,"Wisi! Ipsum maecenas ullamcorper dapibus pede imperdiet vitae id laoreet aliquam.","Elit et leo imperdiet facilisis potenti eros. Enim euismod proin neque platea tellus primis.",5,5,"negative",22,22,8,9,3,3,4.33333333333333,"Contagion","Highlighted",8,5,4,2,0,-4,1,-1,0
"393",96,4,"Suspendisse. Felis ipsum sodales! Sed in maecenas id? Justo quis.","Posuere pellentesque ullamcorper per et imperdiet! Id dignissim. Iaculis faucibus justo sapien turpis egestas.",4,1,"negative",21,21,1,8,3,3,4.33333333333333,"Contagion","Highlighted",4,5,7,4,3,-3,4,1,2.5
"394",7,3,"Gravida elit maecenas convallis potenti et justo rutrum bibendum venenatis rhoncus.","Sapien aenean lacus iaculis porttitor praesent montes elit atque tortor magna maecenas fringilla.",5,7,"negative",21,22,9,9,5,4,6.66666666666667,"Contagion","Highlighted",7,1,2,7,-2,-8,-3,3,0
"395",84,3,"Ipsum tellus tempus vitae facilisis praesent! Laoreet. Porttitor. Lorem viverra. Dignissim quis.","Fringilla? Dictumst fusce mi sapien malesuada integer vehicula! Dictumst ab rutrum cras! Turpis, urna.",1,6,"negative",22,22,9,5,1,6,5,"Contagion","Highlighted",7,7,1,1,-2,2,0,-5,-2.5
"396",80,4,"Convallis quam est volutpat sodales posuere aliquam tellus et elit.","Ipsum pharetra? Lorem? Neque, phasellus magna auctor elit turpis nullam.",6,1,"negative",22,22,9,9,9,7,4,"Contagion","Highlighted",6,9,3,7,-3,0,-6,0,-3
"397",56,2,"Mi pede justo malesuada mi primis etiam aliquet vulputate? Elit justo massa.","Primis ab risus orci metus! Sit vitae ut tellus tortor.",6,5,"negative",22,21,4,7,4,3,3.33333333333333,"Contagion","Highlighted",4,7,4,6,0,0,0,3,1.5
"398",53,4,"Orci nonummy eget massa ac! Rutrum justo fringilla magnis? Morbi sagittis.","Ab eros! Eleifend. Ipsum quis pede augue ac viverra nonummy convallis.",3,1,"negative",21,22,1,4,2,2,5.33333333333333,"Contagion","Highlighted",5,6,3,3,4,2,1,1,1
"399",51,4,"Laoreet suscipit gravida! Culpa rhoncus luctus consectetuer a purus vestibulum at vestibulum fermentum.","Tempora proin dignissim erat natoque proin vestibulum gravida tincidunt blandit suscipit aenean.",1,5,"negative",22,22,3,7,6,6,3,"Contagion","Highlighted",8,4,9,4,5,-3,3,-2,0.5
"400",10,2,"Enim! Donec. Ante vivamus. Nunc suscipit dictumst eget risus porttitor.","Felis tempor praesent orci rhoncus nunc aliquet etiam per sit elit donec ipsum.",5,6,"negative",22,21,5,7,5,9,3,"Contagion","Highlighted",8,6,7,2,3,-1,2,-7,-2.5
"401",90,4,"Proin, diam a volutpat consequat. Elementum dapibus luctus atque? Ipsum magnis nibh.","Convallis luctus nullam dolorem sagittis per facilisi dictumst porta. Rutrum scelerisque.",5,1,"negative",21,22,1,9,6,5,3.66666666666667,"Contagion","Decreased",7,7,3,5,6,-2,-3,0,-1.5
"402",93,2,"Laoreet metus sit quam ab arcu ac. In mattis, maecenas purus placerat tortor posuere.","Sodales facilisi. Proin morbi erat temporibus vitae duis est neque leo.",3,2,"negative",21,21,9,3,7,4,6.66666666666667,"Contagion","Decreased",7,3,2,4,-2,0,-5,0,-2.5
"403",46,1,"Faucibus eleifend imperdiet. Eleifend lacus ante. Suscipit? Vivamus lacus temporibus bibendum platea atque.","Felis! Gravida! Odio dolor at praesent vivamus sit tempus vulputate tempor.",4,7,"negative",22,21,8,4,8,3,7.66666666666667,"Contagion","Decreased",4,5,3,8,-4,1,-5,5,0
"404",59,3,"Elit felis suspendisse purus in in lectus? Tortor? Per. Vestibulum ultrices.","Rhoncus massa sem amet id risus sem facilisis gravida! Cursus pellentesque wisi magnis ipsum.",6,5,"negative",22,22,4,1,1,5,8,"Contagion","Decreased",7,9,1,5,3,8,0,0,0
"405",54,1,"Pellentesque magna tellus suscipit? Ullamcorper rutrum tortor cursus vestibulum magna ligula. Euismod? Amet mauris.","Facilisi, atque? Pretium non, iaculis pellentesque? Praesent tempus cras pharetra? Pharetra ridiculus curabitur nec phasellus.",6,3,"negative",21,21,5,2,7,6,3,"Contagion","Decreased",8,9,4,3,3,7,-3,-3,-3
"406",6,3,"Interdum scelerisque, sem tempus ullamcorper accusamus arcu felis temporibus orci enim orci maecenas justo.","Suscipit at augue vivamus. Primis orci? Arcu ullamcorper aliquam! Fringilla nonummy vulputate pellentesque.",4,1,"negative",21,22,1,2,4,3,5.33333333333333,"Contagion","Decreased",2,2,8,9,1,0,4,6,5
"407",31,1,"Vehicula, vitae integer accusamus nulla massa metus dolorem mauris lectus erat bibendum egestas faucibus.","Praesent interdum in vivamus curabitur! Donec magnis pharetra! Vitae laoreet est morbi.",5,6,"negative",21,21,7,2,6,8,6,"Contagion","Decreased",2,8,4,2,-5,6,-2,-6,-4
"408",32,2,"Posuere per ante iaculis. Ultrices consectetuer integer elementum tempora amet dolorem orci aliquet.","Natoque dolorem nec sagittis sed arcu. Pharetra, aliquam integer? Gravida, mi pharetra id augue suspendisse.",5,7,"negative",22,21,6,1,4,7,5.66666666666667,"Contagion","Decreased",5,9,2,3,-1,8,-2,-4,-3
"409",84,3,"Potenti sapien vivamus rutrum non arcu. Sem velit quis ipsum ullamcorper aliquet, ligula.","Nullam est auctor? Nibh iaculis, aenean culpa in ut platea commodo dictumst dictumst.",5,4,"negative",22,22,1,4,6,7,5.33333333333333,"Contagion","Decreased",9,8,4,4,8,4,-2,-3,-2.5
"410",3,3,"Odio. Aliquet, tincidunt sollicitudin lorem mauris vehicula? Etiam nec euismod scelerisque nonummy ipsum non a.","Vel phasellus sed iaculis ridiculus auctor. Diam rutrum maecenas auctor imperdiet luctus placerat tempora morbi.",3,2,"negative",22,22,4,4,8,3,4.33333333333333,"Contagion","Decreased",9,7,1,7,5,3,-7,4,-1.5
"411",82,1,"Mi bibendum? Et nonummy etiam metus euismod tincidunt maecenas curabitur.","Pellentesque urna ante urna sapien curabitur ante ultricies lorem interdum.",1,4,"negative",21,21,1,9,5,2,8.66666666666667,"Contagion","Decreased",7,6,8,7,6,-3,3,5,4
"412",82,2,"Accumsan risus tempora turpis accusamus aliquet auctor. Tempora, convallis tortor purus lacus auctor ultricies euismod.","Lacus, turpis, neque sodales tincidunt malesuada tortor bibendum volutpat. Praesent.",6,7,"negative",22,21,6,9,9,3,6.66666666666667,"Contagion","Decreased",3,5,1,7,-3,-4,-8,4,-2
"413",100,4,"Iaculis pharetra? Turpis urna montes pretium pellentesque! Vehicula porta. Convallis curabitur.","Placerat porta. Tincidunt! Maecenas? Rutrum potenti atque cras posuere culpa luctus, proin amet venenatis pharetra.",2,2,"negative",22,22,3,2,8,1,4.66666666666667,"Contagion","Decreased",2,5,2,9,-1,3,-6,8,1
"414",86,1,"Erat? Sagittis sagittis molestie faucibus culpa et dolorem sagittis convallis ultricies! Viverra, iaculis eu.","Egestas sed velit curabitur sit arcu purus ac ligula! Culpa! Rhoncus metus.",3,3,"negative",22,21,4,2,5,4,3.66666666666667,"Contagion","Decreased",2,6,1,6,-2,4,-4,2,-1
"415",79,2,"Aliquet non molestie quis potenti ridiculus sollicitudin sollicitudin. Massa, orci augue molestie purus. Odio massa.","Luctus aliquet blandit nunc cursus purus nullam. Bibendum! Viverra aliquet? A atque.",4,3,"negative",21,21,9,2,1,5,1.66666666666667,"Contagion","Decreased",9,7,9,3,0,5,8,-2,3
"416",87,1,"Posuere accusamus, consequat leo quam odio enim. Eleifend tempora enim est quam.","Ab venenatis posuere atque dui morbi ultrices proin dictumst diam eu erat.",5,6,"negative",22,21,9,5,8,7,7.66666666666667,"Contagion","Decreased",2,8,3,6,-7,3,-5,-1,-3
"417",82,2,"Pede vulputate rhoncus? Enim ullamcorper atque sollicitudin consequat wisi sem odio, atque phasellus magnis.","Pede sit elit odio non. Dapibus per posuere suscipit. Arcu tempora morbi gravida.",5,3,"negative",22,22,9,8,1,7,5.66666666666667,"Contagion","Decreased",9,5,3,9,0,-3,2,2,2
"418",54,1,"Sollicitudin? Laoreet massa elit metus, purus. Sodales sodales magnis sem fusce urna felis, natoque.","Dui, eu nullam vel felis consectetuer morbi velit rutrum odio.",2,4,"negative",22,21,5,9,8,6,1,"Contagion","Decreased",6,3,4,6,1,-6,-4,0,-2
"419",35,2,"Dui montes tincidunt ut nulla pellentesque magnis eleifend aliquet aliquet.","Turpis, sit placerat! Tellus? Pretium lectus potenti fusce ullamcorper ullamcorper atque.",2,4,"negative",21,21,7,9,4,4,2.66666666666667,"Contagion","Decreased",3,1,4,2,-4,-8,0,-2,-1
"420",97,4,"Mattis amet wisi accumsan ut ridiculus sit amet nonummy? Vulputate pede.","Vivamus ridiculus imperdiet! Sagittis magnis diam vivamus integer odio, cras lacus eros risus.",5,1,"negative",22,22,4,3,8,3,3.33333333333333,"Contagion","Decreased",9,4,4,4,5,1,-4,1,-1.5
"421",92,3,"Dolor nonummy. Felis primis ab tempor duis dolor sit, pede elementum mi iaculis.","Ullamcorper faucibus tempora potenti. Lectus vitae! Montes vivamus fusce phasellus sed.",4,6,"negative",21,22,5,9,9,4,5.33333333333333,"Contagion","Decreased",2,5,8,7,-3,-4,-1,3,1
"422",77,1,"Nunc auctor commodo ante amet quam amet? Volutpat ut elementum id.","Pellentesque facilisi porta facilisi ante eleifend eros iaculis fringilla? Malesuada.",5,7,"negative",21,22,1,3,7,3,4,"Contagion","Decreased",5,8,4,5,4,5,-3,2,-0.5
"423",13,3,"Ipsum per aliquam pede nullam fusce aliquam montes vitae nullam tortor per vestibulum iaculis.","Lacus! In augue! Neque luctus volutpat faucibus scelerisque est metus sapien fusce lectus.",1,4,"negative",22,21,2,6,8,9,6.66666666666667,"Contagion","Decreased",3,9,7,7,1,3,-1,-2,-1.5
"424",48,4,"Lorem pharetra ultrices sit etiam quis. Eget velit interdum tincidunt.","Vestibulum eleifend a tincidunt natoque. Pretium maecenas suspendisse wisi interdum neque rhoncus arcu tempor.",1,4,"negative",21,21,6,4,5,5,7.66666666666667,"Contagion","Decreased",5,6,8,1,-1,2,3,-4,-0.5
"425",0,4,"Pharetra massa primis tempora ultricies suspendisse sagittis aliquam diam per wisi rutrum. Purus dolor? Auctor.","Dui tempus maecenas. Malesuada cras mi proin ac. Ridiculus lectus quis ullamcorper volutpat.",5,4,"negative",22,22,8,8,9,4,4.33333333333333,"Contagion","Decreased",6,3,8,9,-2,-5,-1,5,2
"426",34,4,"Nonummy maecenas velit vehicula aliquet! Eget pretium vestibulum montes dui. Wisi aliquam donec mattis.","Odio felis quam. Gravida auctor montes massa ac non faucibus malesuada aliquet.",5,1,"negative",21,21,3,1,9,6,6,"Contagion","Decreased",7,4,7,9,4,3,-2,3,0.5
"427",90,3,"Temporibus nunc lorem viverra montes aliquam augue? Eget aliquam morbi accumsan.","Per facilisis tempor elit augue fusce tincidunt vehicula aliquet vel felis dignissim pretium donec blandit.",3,6,"negative",21,21,2,7,5,3,4.66666666666667,"Contagion","Decreased",7,4,4,2,5,-3,-1,-1,-1
"428",100,4,"Bibendum. Arcu suscipit ultricies eros. Gravida dolorem eros volutpat, bibendum interdum. Nulla eu.","Pharetra. Ligula velit, tortor etiam malesuada. Amet dui sollicitudin ligula in. Quis.",6,7,"negative",21,21,9,9,3,8,4.66666666666667,"Contagion","Decreased",4,8,1,5,-5,-1,-2,-3,-2.5
"429",2,4,"Tortor cras gravida malesuada aenean nullam at vitae arcu? Pretium, augue lectus, leo.","Accumsan accumsan venenatis sed nibh bibendum, id massa vitae eget.",4,3,"negative",21,21,9,5,8,6,4.66666666666667,"Contagion","Decreased",1,1,6,8,-8,-4,-2,2,0
"430",43,1,"Potenti mauris pharetra est? Magna ante platea ab at dolorem tortor nonummy.","Per dolorem fermentum sollicitudin id, maecenas vehicula tempor sodales! Potenti est erat sed ante.",2,7,"negative",21,21,2,7,3,3,8,"Contagion","Decreased",1,7,8,6,-1,0,5,3,4
"431",53,1,"Suscipit lorem laoreet proin venenatis nibh praesent id in? Leo.","Temporibus platea euismod at tortor. Montes magnis, euismod. Curabitur tempor aenean.",5,4,"negative",21,21,7,6,7,3,4.33333333333333,"Contagion","Decreased",9,4,7,1,2,-2,0,-2,-1
"432",20,1,"Curabitur euismod dictumst magna nullam cras. Dignissim. Praesent ipsum malesuada. Sem.","Elit egestas aliquam luctus luctus tincidunt rhoncus luctus mauris luctus aliquam sem.",4,4,"negative",21,21,1,7,4,7,6.33333333333333,"Contagion","Decreased",4,1,5,9,3,-6,1,2,1.5
"433",43,3,"Morbi, culpa porttitor accusamus a turpis eros elementum. Accumsan sit sodales facilisis! Posuere rutrum ultricies.","Velit! Elit nibh mattis aliquet maecenas vestibulum et aliquet vivamus laoreet dolorem! Sagittis elit.",6,7,"negative",21,22,8,1,5,4,6,"Contagion","Decreased",7,6,5,6,-1,5,0,2,1
"434",41,1,"Egestas faucibus rhoncus morbi in cras id donec! Blandit, aliquam euismod.","Atque per magna magna integer per vitae natoque pellentesque rhoncus dignissim augue.",2,3,"negative",22,22,2,3,1,3,5,"Contagion","Decreased",9,2,1,2,7,-1,0,-1,-0.5
"435",78,4,"Proin accusamus dolor magnis velit! Duis eros lorem est, vestibulum, cras. Sit.","Sed laoreet aenean pede. Enim tellus lacus id. Magnis! Arcu.",6,6,"negative",21,21,8,3,8,5,7.33333333333333,"Contagion","Decreased",1,5,8,4,-7,2,0,-1,-0.5
"436",9,1,"Eros temporibus pellentesque scelerisque tellus sem phasellus, aliquet ut viverra aliquam? Facilisi! Dui suspendisse.","Accumsan dolor molestie? Tempor placerat tempor ut vivamus tempor? Vivamus ante dictumst donec.",3,4,"negative",22,21,3,5,5,3,6.66666666666667,"Contagion","Decreased",8,5,7,1,5,0,2,-2,0
"437",73,3,"Malesuada. Fusce odio. Ac, imperdiet. Augue ut. Ridiculus wisi ante sed placerat. Suscipit.","Ab suspendisse. Urna commodo vestibulum eu non. Porta nulla nec.",6,7,"negative",22,21,7,7,4,6,4,"Contagion","Decreased",1,8,6,9,-6,1,2,3,2.5
"438",19,1,"Purus volutpat montes felis? Massa quam fusce eros praesent, potenti iaculis pretium, accumsan sodales tincidunt.","Fringilla nulla justo fusce proin primis dui duis odio metus.",4,2,"negative",21,21,3,2,8,3,5.66666666666667,"Contagion","Decreased",5,7,3,8,2,5,-5,5,0
"439",11,2,"Vitae curabitur! Volutpat potenti etiam ac et. Aliquet temporibus morbi lacus enim? Platea placerat pellentesque.","Dolorem integer rutrum volutpat tempus luctus potenti magna? Sodales. Elit interdum? Vehicula.",4,5,"negative",21,21,5,1,7,4,4.66666666666667,"Contagion","Decreased",4,6,2,7,-1,5,-5,3,-1
"440",16,3,"Fusce dapibus eleifend. Eu? Fringilla. Est porta vulputate eros pretium.","Eros rhoncus vel nunc erat! Auctor tortor odio ridiculus dapibus.",5,4,"negative",22,21,7,9,3,3,6,"Contagion","Decreased",4,6,8,9,-3,-3,5,6,5.5
"441",26,1,"Ultrices facilisis, pellentesque eget rutrum tincidunt aliquet? Morbi in eu molestie, metus auctor donec.","At quam ultricies. Tellus mattis eros quis? Phasellus urna vel metus dictumst rhoncus porttitor.",5,6,"negative",22,22,7,9,3,2,3.33333333333333,"Contagion","Decreased",5,2,8,5,-2,-7,5,3,4
"442",82,4,"Leo ab nunc? Euismod pharetra tincidunt cras eros egestas ut molestie accumsan.","Pharetra? At ligula! Eleifend. Id! Arcu arcu tempora. Facilisis etiam facilisi ipsum sed.",1,1,"negative",22,22,9,3,1,7,4.66666666666667,"Contagion","Decreased",9,3,1,8,0,0,0,1,0.5
"443",61,4,"Eleifend diam gravida. Egestas ridiculus fermentum elementum! Lorem ante? Ligula turpis! Suspendisse rhoncus sem? Vestibulum.","Et suspendisse! Pellentesque. Luctus aenean pede! Facilisis sapien leo posuere.",3,6,"negative",21,22,8,4,6,1,3,"Contagion","Decreased",5,9,2,6,-3,5,-4,5,0.5
"444",93,1,"Bibendum lectus ipsum, fermentum mattis ridiculus accusamus nunc viverra aliquam id ultrices.","Imperdiet ut malesuada gravida atque. Vel eu lorem, tellus commodo at purus dignissim? Augue fermentum.",6,5,"negative",21,21,6,5,6,3,5.66666666666667,"Contagion","Decreased",4,5,7,3,-2,0,1,0,0.5
"445",31,4,"Faucibus magnis platea est elementum consectetuer tortor orci ullamcorper metus. At et fermentum, in.","Sit augue massa vehicula est duis purus montes temporibus! Praesent, eleifend phasellus.",3,7,"negative",21,21,8,9,4,8,5.33333333333333,"Contagion","Decreased",9,2,9,4,1,-7,5,-4,0.5
"446",85,3,"Nullam blandit lectus mattis tellus rhoncus tellus per etiam atque. Facilisi.","Cursus sit orci accusamus curabitur massa! Accusamus nullam venenatis. Venenatis tempus mi quis mauris.",2,5,"negative",22,22,6,2,5,9,7,"Contagion","Decreased",9,8,1,7,3,6,-4,-2,-3
"447",84,3,"Porta ligula ut id molestie porttitor eleifend amet iaculis consectetuer.","Tempus enim amet quam amet, velit atque dolorem dolorem urna dapibus porttitor rhoncus.",3,2,"negative",22,22,8,3,1,5,7.66666666666667,"Contagion","Decreased",8,3,1,5,0,0,0,0,0
"448",68,1,"Nec egestas! Venenatis porttitor justo dui quis dui erat ligula.","Temporibus eros ultrices auctor dolorem neque rhoncus aenean integer! Etiam, sollicitudin vulputate? Pharetra.",4,6,"negative",21,21,8,5,3,7,6.66666666666667,"Contagion","Decreased",5,1,5,6,-3,-4,2,-1,0.5
"449",38,1,"Sed integer viverra aliquam suspendisse? Donec dapibus, convallis faucibus pellentesque dolorem id platea risus ante.","Iaculis. In? Lectus tellus donec. Ab donec proin etiam sapien nonummy. Tortor.",1,1,"negative",21,22,1,6,8,7,4.66666666666667,"Contagion","Decreased",5,9,8,9,4,3,0,2,1
"450",23,2,"Sed cras natoque non ipsum atque potenti magnis proin vel elementum malesuada sit facilisis.","Ligula natoque aenean laoreet ligula in consectetuer vivamus ut praesent.",1,3,"negative",21,21,2,9,5,3,5.66666666666667,"Contagion","Decreased",5,5,5,5,3,-4,0,2,1
"451",36,1,"Purus suspendisse proin leo accumsan pharetra consequat mi integer ab leo? Tellus convallis odio nec.","Temporibus erat wisi faucibus platea fringilla. Leo, malesuada cursus! Vestibulum dui ab.",1,1,"negative",22,21,1,8,7,6,2.66666666666667,"Contagion","Decreased",9,5,1,4,8,-3,-6,-2,-4
"452",60,2,"Etiam vivamus suscipit aliquet ridiculus nibh arcu ab eros sed accumsan ultrices suspendisse per pede.","Accumsan elementum sagittis lectus accusamus pede. Porttitor nulla. Tincidunt at luctus rutrum.",6,3,"negative",22,22,3,9,9,9,4.66666666666667,"Contagion","Decreased",6,8,6,8,3,-1,-3,-1,-2
"453",44,1,"Odio? Turpis sodales! Rutrum potenti. Magna ullamcorper praesent risus et lacus egestas! Commodo.","Tortor culpa phasellus. Dolorem tempus aenean iaculis in turpis facilisi.",2,2,"negative",21,22,5,5,5,8,2.33333333333333,"Contagion","Decreased",3,9,1,1,-2,4,-4,-7,-5.5
"454",45,3,"Molestie nibh dui lorem lacus quam! Purus in. Curabitur atque scelerisque.","Vitae vestibulum atque. A mauris sem! Tincidunt sapien pharetra eget magnis.",6,3,"negative",21,22,5,8,1,9,5.33333333333333,"Contagion","Decreased",1,1,4,3,-4,-7,3,-6,-1.5
"455",97,4,"Tempor velit? Sem dignissim vitae wisi volutpat dictumst. Integer non. Turpis aenean ante enim.","Elementum. Natoque velit eu. Ac dui velit platea? Urna malesuada wisi magna elementum.",3,3,"negative",22,22,7,7,4,2,6,"Contagion","Decreased",1,6,2,1,-6,-1,-2,-1,-1.5
"456",39,3,"Elit pede! Interdum dolor gravida ultricies! Dignissim ligula iaculis consequat quis? Vel tempor? Luctus.","Dictumst at arcu augue primis tempor orci lorem! Fusce sollicitudin nunc? Facilisi id. Proin.",6,7,"negative",22,22,6,5,1,5,5.66666666666667,"Contagion","Decreased",5,7,7,5,-1,2,6,0,3
"457",56,3,"Laoreet dignissim egestas. Rutrum elementum iaculis dolor? Turpis per facilisis elementum.","Aliquam magnis, mattis sem morbi. Diam aenean cursus pede! Accumsan duis.",6,4,"negative",22,21,9,8,6,8,3.33333333333333,"Contagion","Decreased",2,1,6,7,-7,-7,0,-1,-0.5
"458",45,1,"Porttitor, ligula accusamus imperdiet est dolor temporibus tincidunt pretium lectus sodales duis.","Enim quam accumsan nunc fringilla aliquet sagittis aliquet. Vulputate. Per suscipit.",6,1,"negative",22,21,7,9,2,3,4,"Contagion","Decreased",5,6,3,5,-2,-3,1,2,1.5
"459",26,3,"Ligula! Cras sed amet accumsan lectus arcu? Phasellus tempor neque ullamcorper temporibus.","Atque bibendum vel? Ut in, ab posuere consequat. Fusce lacus vivamus mi. Dui vestibulum.",1,1,"negative",22,21,7,3,1,1,6.66666666666667,"Contagion","Decreased",6,2,7,6,-1,-1,6,5,5.5
"460",19,3,"In lectus est. Convallis felis magnis massa? Sem, metus tellus. Natoque diam facilisi sapien ultricies.","Natoque odio. Sed dignissim blandit dictumst bibendum auctor ipsum, consectetuer venenatis ab, pretium lectus.",5,7,"negative",22,22,9,8,9,1,6.66666666666667,"Contagion","Decreased",8,9,3,5,-1,1,-6,4,-1
"461",86,2,"Mattis purus etiam? Risus! Volutpat! Nulla platea! Sit accumsan per.","Accumsan tellus consequat integer magnis bibendum convallis elementum? Porttitor atque pellentesque, diam commodo.",4,2,"negative",22,21,9,2,2,4,3.33333333333333,"Contagion","Decreased",8,4,1,3,-1,2,-1,-1,-1
"462",72,2,"Consectetuer luctus ultrices convallis tortor posuere temporibus posuere bibendum at.","Auctor convallis! Proin vehicula odio volutpat porta augue mi suscipit. Facilisis pede nec rhoncus consectetuer.",6,1,"negative",22,22,8,9,8,9,4,"Contagion","Decreased",9,1,2,7,1,-8,-6,-2,-4
"463",25,1,"Fermentum non dignissim. Scelerisque orci? Elit, molestie curabitur aliquet erat cras amet. Tortor pretium vivamus.","Aenean non laoreet. Augue suspendisse nullam non. Amet ut ipsum. Egestas! Arcu.",1,5,"negative",21,21,4,7,6,2,5.66666666666667,"Contagion","Decreased",2,7,6,9,-2,0,0,7,3.5
"464",0,2,"Nullam. Rutrum, ipsum sagittis dapibus sagittis suspendisse imperdiet interdum? Nulla dolorem proin facilisis.","Curabitur primis nullam lacus a. Ante nullam accumsan! Commodo posuere. Sit! Augue porttitor.",1,6,"negative",22,22,3,4,3,4,3,"Contagion","Decreased",5,1,1,6,2,-3,-2,2,0
"465",14,4,"Massa non vestibulum elementum egestas fringilla culpa. Morbi commodo urna bibendum velit sodales sagittis iaculis.","Morbi. Eget! Eu. Ac auctor sodales! Aenean donec fusce nonummy nec, euismod porta.",6,3,"negative",21,21,5,8,1,3,4.66666666666667,"Contagion","Decreased",6,5,7,9,1,-3,6,6,6
"466",2,3,"Vulputate consequat pede pharetra volutpat erat blandit vel ultricies porttitor convallis massa? Consectetuer ac.","Odio? Donec nibh urna auctor venenatis, interdum lorem leo diam facilisis.",1,6,"negative",22,22,9,1,3,1,7.33333333333333,"Contagion","Decreased",8,4,7,2,-1,3,4,1,2.5
"467",41,4,"Quis enim pellentesque aliquet malesuada ultricies vitae praesent aliquam, natoque pede accusamus.","Tincidunt? Etiam, nibh metus enim etiam, diam dolor elit ante, convallis est. Pretium fringilla temporibus.",6,1,"negative",21,22,9,7,5,9,5.33333333333333,"Contagion","Decreased",5,2,2,5,-4,-5,-3,-4,-3.5
"468",85,4,"Non arcu ridiculus dolor, integer at elit velit. Pretium consectetuer iaculis sapien.","Laoreet rutrum gravida sit sollicitudin eleifend primis est. Odio? Tempor tempus.",4,3,"negative",21,22,9,6,2,7,7.66666666666667,"Contagion","Decreased",3,7,2,7,-6,1,0,0,0
"469",45,2,"Eleifend nullam eros phasellus atque donec placerat leo pretium at suscipit augue orci fringilla aliquam.","Laoreet nonummy culpa natoque elit. Proin vitae augue praesent praesent.",3,7,"negative",21,21,5,6,2,2,5.66666666666667,"Contagion","Decreased",3,5,2,4,-2,-1,0,2,1
"470",41,3,"Fusce! Fusce diam porta felis dolor potenti nibh mattis tempor.","In fermentum ante aliquet urna erat fringilla fringilla. Nulla fermentum! Dolor massa.",2,4,"negative",22,21,4,3,7,2,5,"Contagion","Decreased",1,8,7,2,-3,5,0,0,0
"471",65,2,"Non auctor et convallis wisi pretium duis atque platea vivamus ullamcorper sed! Amet? Ut magnis.","Ac venenatis cursus? Dui. Rutrum, molestie. Ultricies ligula volutpat pharetra gravida mauris ridiculus facilisi.",4,3,"negative",21,21,1,6,4,6,3,"Contagion","Decreased",3,2,3,5,2,-4,-1,-1,-1
"472",99,2,"Tortor sit? Pretium viverra. Nibh elit eros integer dignissim tempus suscipit maecenas eleifend.","Magna nonummy curabitur dolorem sed, sollicitudin facilisis eros primis cras? Rhoncus egestas.",6,3,"negative",22,21,3,8,2,6,3,"Contagion","Decreased",2,1,5,6,-1,-7,3,0,1.5
"473",5,3,"Tempus suscipit ultricies ligula diam in diam. Auctor imperdiet wisi etiam.","Lacus sapien praesent molestie non molestie commodo ridiculus faucibus. Ut lectus! Atque.",6,3,"negative",22,22,3,6,5,9,4.66666666666667,"Contagion","Decreased",3,5,5,6,0,-1,0,-3,-1.5
"474",26,4,"Ante, eu nonummy quis faucibus dolorem tempus suspendisse! Mi quis. Malesuada interdum dui.","Volutpat vehicula donec at placerat. Lectus malesuada vestibulum lorem suscipit maecenas dui.",6,1,"negative",21,21,7,8,3,4,4.66666666666667,"Contagion","Decreased",7,8,1,6,0,0,-2,2,0
"475",1,3,"Ante etiam facilisi laoreet tempus. Felis aliquam euismod sem viverra risus vivamus integer.","A commodo arcu ac posuere cursus augue magnis! Sapien. Erat. Nunc culpa venenatis.",4,2,"negative",22,22,7,4,8,6,5.33333333333333,"Contagion","Decreased",4,3,1,8,-3,-1,-7,2,-2.5
"476",48,3,"Volutpat per donec ac nonummy placerat. Per? Vitae dapibus, natoque felis a. Eleifend augue.","Accusamus laoreet phasellus auctor et facilisi! Rhoncus. Wisi pharetra molestie morbi in.",6,1,"negative",22,21,3,9,6,6,5,"Contagion","Decreased",9,7,5,1,6,-2,-1,-5,-3
"477",63,1,"Sem sapien rhoncus, platea accumsan pellentesque felis sapien tempora ullamcorper. Eleifend commodo risus.","Commodo, accumsan duis, odio vehicula nulla? Consectetuer! Fringilla luctus. Morbi.",5,6,"negative",21,22,3,5,6,1,5.33333333333333,"Contagion","Decreased",8,1,4,9,5,-4,-2,8,3
"478",90,4,"Et faucibus! Magna primis magnis erat morbi. Nunc nec vivamus.","Id metus sodales dapibus. Lacus ultrices tortor. Sit turpis viverra.",3,2,"negative",22,21,4,9,8,7,5.66666666666667,"Contagion","Decreased",4,5,3,8,0,-4,-5,1,-2
"479",41,2,"Leo primis sapien iaculis sit elit vestibulum primis ultrices accusamus, faucibus enim! Molestie sodales.","Fusce consequat blandit. Euismod integer suscipit turpis dignissim suscipit id.",3,6,"negative",22,22,8,7,6,4,4.33333333333333,"Contagion","Decreased",7,7,5,3,-1,0,-1,-1,-1
"480",45,1,"Accusamus volutpat ligula natoque vehicula ab maecenas erat vestibulum lorem leo. Pharetra potenti mattis volutpat.","Erat diam dolor! Sit fermentum temporibus curabitur blandit primis vel aenean purus.",2,4,"negative",21,21,1,2,7,1,5,"Contagion","Decreased",3,7,4,4,2,5,-3,3,0
"481",3,4,"Etiam blandit sapien natoque proin aliquam? Sem lacus rutrum pharetra tempor ac! Fusce fermentum id.","Urna eleifend vestibulum accumsan. Potenti massa euismod mi ipsum. Dolorem cursus fringilla commodo molestie.",2,5,"negative",21,22,5,4,2,4,5,"Market Value","Highlighted",4,8,1,3,-1,4,-1,-1,-1
"482",55,4,"A! Porta interdum ultrices enim atque temporibus ligula ullamcorper laoreet montes posuere mauris blandit.","Risus, nulla luctus sapien atque sagittis egestas nunc faucibus suscipit odio et.",4,6,"negative",21,22,3,3,4,5,5,"Market Value","Highlighted",9,2,6,2,6,-1,2,-3,-0.5
"483",83,3,"Augue sem nullam! Platea phasellus augue. Dictumst aenean enim sagittis.","Orci fermentum sed. Consectetuer nunc amet. Vitae tellus. Integer lacus a rutrum consectetuer dui phasellus.",3,2,"negative",21,22,2,4,4,2,5.33333333333333,"Market Value","Highlighted",5,8,8,8,3,4,4,6,5
"484",87,2,"Platea eleifend? Maecenas platea at pharetra elit sodales diam. Wisi, duis, turpis.","Accusamus ac dolor convallis tincidunt imperdiet. Iaculis pede bibendum! Urna.",4,2,"negative",21,21,8,8,5,4,5,"Market Value","Highlighted",2,7,9,4,-6,-1,4,0,2
"485",2,3,"Potenti atque velit lacus rhoncus? Culpa justo. Cras felis lorem culpa purus justo.","Pharetra morbi? Ab. Non facilisis? Vel consectetuer bibendum duis? Morbi magna rutrum sodales gravida bibendum.",5,6,"negative",21,22,7,4,7,4,5,"Market Value","Highlighted",6,5,4,1,-1,1,-3,-3,-3
"486",45,1,"Auctor elit lorem. Scelerisque. Arcu! Elit tempora molestie tempus? Amet.","Morbi? Nec id proin fringilla dolor. Primis convallis! Sapien scelerisque consectetuer.",2,5,"negative",22,21,8,9,5,9,3.33333333333333,"Market Value","Highlighted",1,4,7,7,-7,-5,2,-2,0
"487",97,3,"Atque risus fringilla luctus? Ullamcorper malesuada ultricies rutrum ridiculus orci maecenas egestas? Commodo.","Accusamus pede imperdiet eleifend etiam! Ultricies commodo! Nunc dignissim eu. Orci. Dolor laoreet.",2,2,"negative",21,21,8,8,4,2,4.66666666666667,"Market Value","Highlighted",6,5,9,3,-2,-3,5,1,3
"488",18,1,"Ipsum ultrices nulla curabitur dapibus viverra nulla felis risus? Amet velit.","Consectetuer platea dui eu phasellus ligula mauris malesuada elementum? Elementum venenatis aliquam.",6,5,"negative",21,21,7,5,9,6,4.66666666666667,"Market Value","Highlighted",9,8,2,8,2,3,-7,2,-2.5
"489",18,1,"Mattis phasellus porttitor luctus id? Dignissim cursus dapibus elit ipsum, auctor curabitur pellentesque sapien.","Arcu tempor sagittis est ipsum ullamcorper morbi per vitae malesuada fusce dolor temporibus.",3,7,"negative",22,22,3,7,7,2,5.66666666666667,"Market Value","Highlighted",4,3,5,9,1,-4,-2,7,2.5
"490",45,2,"Iaculis! Nullam tempora! Ullamcorper id. Tempora, malesuada atque ipsum nibh.","Dictumst vulputate lorem ullamcorper sem sagittis urna! Praesent, morbi. Nullam tempora.",1,1,"negative",22,21,5,3,7,5,5,"Market Value","Highlighted",4,3,3,5,-1,0,-4,0,-2
"491",87,2,"Leo tellus lorem accusamus! Magnis fermentum tempor, amet porta nonummy pharetra arcu neque convallis lorem.","Arcu. Lorem egestas mattis lacus egestas duis. Vivamus dui diam luctus.",5,1,"negative",21,22,4,5,3,7,6,"Market Value","Highlighted",8,7,2,4,4,2,-1,-3,-2
"492",23,2,"Mattis ullamcorper magnis eros nec vel venenatis vulputate pharetra odio? Pretium ullamcorper ac. Proin.","Platea tempus culpa laoreet? Diam tellus etiam consequat? Etiam? Rutrum.",5,6,"negative",21,22,5,1,3,6,2.66666666666667,"Market Value","Highlighted",2,7,1,7,-3,6,-2,1,-0.5
"493",63,2,"Magnis, leo lacus felis dolor ultricies! Felis egestas eu eu rutrum.","Natoque vestibulum et sapien cras fringilla! Elementum praesent magna? Felis elit.",2,6,"negative",21,22,2,2,2,3,7,"Market Value","Highlighted",8,6,9,3,6,4,7,0,3.5
"494",36,4,"Ante facilisis. Neque et maecenas fringilla sagittis? Rutrum rhoncus fermentum? Rutrum tempor.","Wisi dignissim, malesuada. Per? Suscipit mi mattis at est atque. Id.",5,6,"negative",22,21,9,7,9,3,6.66666666666667,"Market Value","Highlighted",9,6,6,7,0,-1,-3,4,0.5
"495",77,2,"Duis sed praesent leo ante? Cursus magna ut integer augue nibh.","Volutpat imperdiet. Aliquam cursus auctor magnis faucibus sed erat at? Tempus.",1,6,"negative",22,22,1,9,9,4,1.66666666666667,"Market Value","Highlighted",5,2,3,5,4,-7,-6,1,-2.5
"496",59,4,"Volutpat ut. Praesent facilisi risus lorem, magnis vitae potenti phasellus tellus ultricies.","Odio iaculis ullamcorper? Atque! Fusce praesent maecenas mi praesent ut laoreet tempor.",2,6,"negative",22,21,5,8,3,1,6.66666666666667,"Market Value","Highlighted",8,9,6,3,3,1,3,2,2.5
"497",63,3,"Culpa, malesuada porta auctor purus eget ligula pede! Potenti tincidunt bibendum culpa laoreet facilisis.","Sem luctus nunc ante amet! Eget, odio rhoncus ipsum ultrices amet, integer scelerisque proin.",2,3,"negative",21,22,6,7,6,9,5.33333333333333,"Market Value","Highlighted",1,9,8,5,-5,2,2,-4,-1
"498",7,2,"Vel aliquam magnis ab vehicula ligula ultricies ab luctus tempor eget aenean.","Sodales donec nibh temporibus, felis egestas dictumst risus bibendum sagittis urna.",4,5,"negative",21,22,3,7,4,5,5.33333333333333,"Market Value","Highlighted",8,9,9,2,5,2,5,-3,1
"499",73,1,"Arcu? Diam, porttitor donec facilisis! Molestie augue auctor elementum metus orci egestas vestibulum faucibus tincidunt.","Vitae. Dolor molestie massa non fermentum nunc posuere. Leo temporibus.",4,6,"negative",21,21,4,7,4,3,4.66666666666667,"Market Value","Highlighted",3,9,9,8,-1,2,5,5,5
"500",68,4,"Dictumst faucibus porta suscipit ultricies luctus vehicula integer pellentesque purus placerat.","Eleifend enim dolorem vel duis elementum felis? Leo ipsum odio eget sodales? Molestie eros.",6,6,"negative",21,22,6,8,8,1,4.66666666666667,"Market Value","Highlighted",5,4,2,1,-1,-4,-6,0,-3
"501",62,3,"Volutpat! Est! Lorem. Wisi suspendisse amet enim! Metus enim. Viverra vestibulum sollicitudin. Erat eleifend.","Suscipit! Curabitur volutpat scelerisque porttitor? Proin tincidunt wisi enim! Mi sapien.",1,4,"negative",22,22,1,9,6,9,1.33333333333333,"Market Value","Highlighted",1,1,6,7,0,-8,0,-2,-1
"502",98,2,"Sit? Tortor sit id accusamus felis risus dictumst nonummy, a sem duis.","Porta risus augue? Ullamcorper ut suscipit, eu vestibulum faucibus eros.",2,7,"negative",21,21,9,7,4,7,7.66666666666667,"Market Value","Highlighted",9,3,9,7,0,-4,5,0,2.5
"503",88,1,"Culpa. Porta nulla tempus ipsum accusamus quam? Enim? Sed ultrices ac dui.","Venenatis euismod nulla id augue, posuere a montes, egestas rhoncus interdum vivamus dolor neque.",6,4,"negative",22,21,4,1,3,1,4,"Market Value","Highlighted",2,6,2,7,-2,5,-1,6,2.5
"504",93,3,"Auctor lectus porttitor consequat quam nonummy accumsan ridiculus accumsan eu sit! Temporibus. Interdum mattis donec.","Rutrum pharetra. Ultrices pharetra elit sapien quis donec consectetuer scelerisque posuere sit ante tempora. Est.",2,7,"negative",22,22,4,9,4,6,2.66666666666667,"Market Value","Highlighted",2,9,4,6,-2,0,0,0,0
"505",36,2,"Tincidunt atque ab. Morbi. Dapibus vel sem enim imperdiet. Proin.","Accumsan mauris! Quis nec felis. Quam ab. Aliquam tempus. Etiam.",6,3,"negative",21,21,4,8,6,7,7,"Market Value","Highlighted",7,1,6,7,3,-7,0,0,0
"506",90,1,"Dictumst consequat tempora phasellus tellus temporibus vulputate erat nec at. Dolor orci.","Per gravida convallis potenti interdum. Mauris viverra dignissim vitae est! Cras ligula. Temporibus.",3,3,"negative",22,22,7,5,1,8,5.33333333333333,"Market Value","Highlighted",7,1,6,9,0,-4,5,1,3
"507",5,3,"Tellus aliquam in sodales urna? Suspendisse eleifend iaculis sem. Porttitor sit egestas.","Pretium mattis. Elementum accusamus eros volutpat dui proin tellus eros morbi.",2,1,"negative",21,21,9,7,2,8,5.66666666666667,"Market Value","Highlighted",5,3,9,7,-4,-4,7,-1,3
"508",90,3,"Purus, vestibulum! Aliquam. Etiam molestie integer. Natoque? Rutrum natoque tempora malesuada blandit.","Pellentesque ab diam eleifend tempor. Wisi. Wisi, nonummy commodo culpa! Augue massa.",3,3,"negative",22,22,5,9,5,8,3.66666666666667,"Market Value","Highlighted",2,6,4,4,-3,-3,-1,-4,-2.5
"509",81,1,"At facilisi dolor nibh donec erat suscipit euismod porta elementum tortor scelerisque.","Fringilla! Tempus enim sapien tellus aliquam rhoncus sollicitudin! Pede nec posuere? Nullam.",3,6,"negative",21,22,9,6,9,5,4.33333333333333,"Market Value","Highlighted",7,4,6,4,-2,-2,-3,-1,-2
"510",43,1,"Ultrices malesuada vestibulum eros pede fringilla, ipsum purus scelerisque sodales magnis. Fermentum morbi.","Lacus et felis molestie augue viverra placerat vitae dui sem euismod wisi ultricies volutpat.",5,1,"negative",21,21,2,5,9,8,3,"Market Value","Highlighted",2,8,6,3,0,3,-3,-5,-4
"511",98,2,"Arcu nullam morbi, eget dignissim volutpat! Purus arcu, placerat eleifend ipsum volutpat. Nonummy vulputate faucibus.","Wisi venenatis morbi pellentesque massa vestibulum amet vehicula cras rhoncus.",3,4,"negative",22,22,8,1,2,3,3.66666666666667,"Market Value","Highlighted",5,3,1,3,-3,2,-1,0,-0.5
"512",17,4,"Faucibus, sed sem donec praesent ligula facilisis risus enim, iaculis nullam.","Wisi ac faucibus, in! Facilisis placerat viverra sodales, ligula suscipit risus. In magnis.",3,6,"negative",21,21,6,5,8,5,6.33333333333333,"Market Value","Highlighted",9,7,3,8,3,2,-5,3,-1
"513",61,2,"Ac. Vestibulum. Lacus proin mattis. Consequat nunc quis felis pede. Platea.","Est enim rutrum. Id eget atque arcu quis nibh non arcu ultricies pharetra nunc.",2,2,"negative",22,22,2,1,9,2,6,"Market Value","Highlighted",1,1,2,6,-1,0,-7,4,-1.5
"514",80,4,"Urna, morbi at leo? Est. Integer ac suscipit suspendisse urna. Cras, mauris.","Gravida elit dictumst rutrum cursus elementum posuere? Tempor, massa mauris. Sapien viverra sollicitudin vel per.",1,5,"negative",22,22,4,9,2,9,5.33333333333333,"Market Value","Highlighted",6,6,6,5,2,-3,4,-4,0
"515",6,2,"Ligula volutpat laoreet? Massa venenatis ab et. Dui nulla dictumst porttitor! Tempora placerat interdum.","Mi odio enim nulla! Montes praesent, ultrices vel suspendisse, tempor.",3,1,"negative",22,22,2,8,5,5,6.66666666666667,"Market Value","Highlighted",7,9,6,9,5,1,1,4,2.5
"516",22,4,"Cras suspendisse odio, turpis malesuada nunc per nec enim arcu.","Sem etiam culpa malesuada elementum bibendum dapibus facilisis? Ullamcorper luctus.",2,1,"negative",21,22,2,7,6,8,6.66666666666667,"Market Value","Highlighted",4,3,4,2,2,-4,-2,-6,-4
"517",5,2,"Pellentesque lacus donec. Orci sed amet sagittis dignissim nunc ultricies.","Quam dignissim aenean lacus? Amet nullam urna? Vel primis per sapien. Vehicula. Elit.",3,5,"negative",22,22,6,2,1,4,4,"Market Value","Highlighted",6,6,3,1,0,4,2,-3,-0.5
"518",53,2,"Bibendum at! Aliquet a facilisis ullamcorper maecenas a! Integer elit.","Potenti! Pellentesque id aliquet dolorem consequat rhoncus velit ante consectetuer metus rhoncus.",1,6,"negative",22,22,4,6,3,6,1.66666666666667,"Market Value","Highlighted",7,2,3,8,3,-4,0,2,1
"519",5,4,"Per maecenas tempus. Culpa euismod vel proin, elit porta gravida integer. Aenean quam, ab pellentesque.","Justo commodo proin dapibus pellentesque velit et amet ac praesent integer.",3,2,"negative",21,21,1,5,2,2,6.66666666666667,"Market Value","Highlighted",9,3,9,7,8,-2,7,5,6
"520",17,3,"Porttitor. Sagittis ut luctus pellentesque purus malesuada. Facilisi. Ac! Eget.","Ullamcorper et lacus nonummy! Natoque fusce proin tortor augue dolorem.",2,2,"negative",22,21,4,6,9,4,6,"Market Value","Highlighted",9,1,9,5,5,-5,0,1,0.5
"521",18,2,"Imperdiet iaculis integer nibh consequat vel primis commodo praesent? Blandit diam fusce dui! Elementum.","Nibh in pede vulputate dapibus dapibus risus elit sem facilisis eros sem. Curabitur! Nullam.",2,4,"negative",22,22,6,4,3,6,5,"Market Value","Highlighted",8,9,2,3,2,5,-1,-3,-2
"522",16,2,"Ac suscipit montes aliquam duis justo ullamcorper nunc tempor. Sapien fringilla. Justo erat.","Dolor mi leo vestibulum phasellus consequat non temporibus convallis auctor vel vivamus per diam.",6,5,"negative",21,22,5,2,6,7,5,"Market Value","Highlighted",8,7,4,2,3,5,-2,-5,-3.5
"523",51,4,"Sagittis euismod rutrum! Rutrum. Potenti per. Culpa arcu vestibulum platea pharetra nullam eros. In.","Neque lacus magna sed sem dolorem a elementum odio sit.",2,1,"negative",21,22,3,6,7,8,5.33333333333333,"Market Value","Highlighted",8,1,8,8,5,-5,1,0,0.5
"524",72,1,"Blandit malesuada sollicitudin. Rutrum nullam dolor volutpat potenti et sagittis ab, et.","Faucibus et tellus felis phasellus. Quis natoque. Blandit viverra? Nibh.",3,6,"negative",21,21,8,6,3,1,6.66666666666667,"Market Value","Highlighted",4,1,5,9,-4,-5,2,8,5
"525",45,4,"Imperdiet ultricies sapien egestas arcu per, scelerisque scelerisque curabitur pellentesque porttitor.","Iaculis dignissim morbi euismod eros aliquam in facilisis tempor eros euismod mi primis. Amet.",2,5,"negative",21,21,1,1,2,9,3.33333333333333,"Market Value","Highlighted",7,4,1,5,6,3,-1,-4,-2.5
"526",98,4,"Tortor auctor fermentum bibendum. Auctor faucibus tempor nullam, integer morbi augue culpa, consectetuer.","Mauris. Sit dapibus massa potenti aliquet dolorem commodo venenatis. Iaculis culpa a. Sapien ullamcorper.",6,6,"negative",22,21,9,6,4,7,4.33333333333333,"Market Value","Highlighted",2,8,7,5,-7,2,3,-2,0.5
"527",40,1,"Posuere nonummy eget posuere urna convallis. Platea magna in facilisi? Temporibus accumsan donec malesuada.","Facilisi fringilla ultricies pretium fusce eu aliquet ligula dictumst cras! Duis.",5,4,"negative",21,22,2,8,8,2,5.66666666666667,"Market Value","Highlighted",3,8,3,2,1,0,-5,0,-2.5
"528",32,2,"Consectetuer tortor non. Lorem. Laoreet viverra rutrum, bibendum fermentum scelerisque ligula.","Viverra, mi diam, accusamus scelerisque vulputate urna. Posuere blandit magnis.",1,1,"negative",21,21,2,3,9,3,5.66666666666667,"Market Value","Highlighted",8,5,8,9,6,2,-1,6,2.5
"529",51,2,"Accumsan a ligula tellus id ultricies facilisis per, non tellus euismod nibh praesent. Dignissim ac.","Maecenas sed purus est pede sollicitudin felis consequat facilisi a curabitur.",1,4,"negative",21,22,8,9,3,3,3.33333333333333,"Market Value","Highlighted",8,9,8,2,0,0,5,-1,2
"530",22,2,"Pretium viverra tempora gravida felis lorem accusamus sagittis tempor fusce. Potenti. Commodo lorem. Curabitur ultricies.","Temporibus vel atque eu metus sollicitudin vestibulum. Quis felis amet vehicula arcu.",3,7,"negative",21,21,6,2,7,8,5,"Market Value","Highlighted",7,2,8,3,1,0,1,-5,-2
"531",29,2,"Integer, egestas morbi dignissim lacus. Natoque. Cursus nibh consequat ridiculus ante ante primis.","Amet. Leo. Tempus culpa eros pretium vehicula sed ullamcorper dapibus at? Ultrices? Vel. Eget.",2,3,"negative",22,22,3,1,1,1,2.66666666666667,"Market Value","Highlighted",2,7,2,3,-1,6,1,2,1.5
"532",73,3,"Faucibus elementum nonummy temporibus nulla! Per, vitae wisi potenti vivamus? Per orci nec justo fringilla.","Rhoncus eleifend! Nibh accumsan wisi lorem nunc platea odio natoque accumsan praesent. Volutpat orci.",2,5,"negative",21,21,4,8,5,4,3.33333333333333,"Market Value","Highlighted",6,9,3,2,2,1,-2,-2,-2
"533",78,2,"Ac dictumst. Pharetra? Pretium consectetuer temporibus facilisis felis? Proin mattis a interdum turpis.","Ab leo! Lorem! Quis porttitor augue rhoncus? Posuere ac ridiculus justo eros duis.",3,7,"negative",22,22,7,9,2,3,3.33333333333333,"Market Value","Highlighted",5,8,1,1,-2,-1,-1,-2,-1.5
"534",4,4,"Mauris curabitur primis temporibus iaculis eu nullam ab convallis. Sollicitudin.","Arcu dictumst tempus urna iaculis dapibus suscipit. Duis id, id erat massa duis suspendisse dolor.",3,4,"negative",21,21,1,3,9,4,2.33333333333333,"Market Value","Highlighted",7,4,2,8,6,1,-7,4,-1.5
"535",9,3,"Laoreet sed suscipit, tempor vel laoreet ligula luctus. Vulputate convallis aliquet duis turpis! Porta.","Vivamus cras quam tincidunt natoque laoreet volutpat phasellus lorem potenti quis cursus turpis ab.",6,6,"negative",21,22,1,9,6,4,5,"Market Value","Highlighted",2,5,4,9,1,-4,-2,5,1.5
"536",68,1,"Etiam. Velit elementum amet est fusce morbi. Vehicula! Vitae iaculis.","Consectetuer? Mi mattis luctus atque suscipit. Lacus iaculis est aliquam neque euismod.",2,6,"negative",21,22,9,2,2,4,6.66666666666667,"Market Value","Highlighted",2,5,2,4,-7,3,0,0,0
"537",27,2,"Eu? Elit est dictumst. Dui atque, viverra posuere proin. Quam. Curabitur atque cras.","Iaculis urna ligula quam nibh fringilla. Eget at! Fringilla. Proin, tincidunt cursus? Magna.",2,7,"negative",22,22,7,1,2,3,7,"Market Value","Highlighted",1,9,3,1,-6,8,1,-2,-0.5
"538",52,3,"Iaculis primis viverra sollicitudin a convallis! Magna aliquam tempus risus bibendum pede felis per. Turpis.","Donec natoque ac mi primis ut! Rutrum egestas, vel primis cursus.",5,6,"negative",21,21,9,9,4,3,2.33333333333333,"Market Value","Highlighted",1,4,6,7,-8,-5,2,4,3
"539",8,4,"Vulputate velit sit. Commodo faucibus atque pharetra? Quis volutpat? A odio.","Per at quis eros id tincidunt. Suspendisse, praesent! Risus ultricies sit viverra aenean magnis.",1,2,"negative",21,22,8,2,2,9,6,"Market Value","Highlighted",1,6,7,1,-7,4,5,-8,-1.5
"540",41,4,"Fermentum tempus quam risus porttitor tempor, sagittis duis? Arcu porttitor laoreet.","Eros natoque eleifend consequat vel pellentesque suscipit? Porta ridiculus interdum tempora, magna elementum.",4,5,"negative",21,21,6,4,7,9,7.66666666666667,"Market Value","Highlighted",4,4,6,7,-2,0,-1,-2,-1.5
"541",60,1,"Morbi gravida at, accusamus sapien eu tempora consectetuer etiam dapibus aliquet vestibulum.","Sapien venenatis a consectetuer gravida integer platea mi, fringilla? Montes lacus orci dui etiam. Nibh.",3,5,"negative",21,22,1,4,6,5,9,"Market Value","Highlighted",7,8,4,1,6,4,-2,-4,-3
"542",42,2,"Per risus dignissim vehicula. Nibh, rutrum porta tempora ridiculus mattis fringilla? Metus massa.","Lectus aenean. Aliquet vel morbi metus id nunc fermentum eros ante.",5,7,"negative",21,21,8,1,5,3,7,"Market Value","Highlighted",7,5,2,2,-1,4,-3,-1,-2
"543",60,1,"Fermentum? Eu euismod vulputate in nec. Lorem velit, sapien ultrices at nulla sagittis.","Enim felis accumsan, tempus. Fusce eleifend viverra purus ligula metus eros.",3,5,"negative",21,22,2,6,5,3,5.33333333333333,"Market Value","Highlighted",7,5,9,9,5,-1,4,6,5
"544",67,4,"Faucibus urna lectus metus. Cursus vivamus montes erat in integer tortor quis vestibulum.","Nulla sollicitudin erat elit dui? Augue integer fringilla? Sem porta vehicula ac est sagittis? Proin.",1,7,"negative",21,22,1,6,1,6,2,"Market Value","Highlighted",4,6,5,9,3,0,4,3,3.5
"545",79,2,"Praesent augue platea elementum auctor purus, vulputate integer sollicitudin facilisis, elit gravida suspendisse nec.","Blandit dui! Integer vel pellentesque interdum dolor? Aenean integer wisi dapibus.",2,6,"negative",21,22,3,5,2,8,2,"Market Value","Highlighted",4,6,7,5,1,1,5,-3,1
"546",43,4,"Tempora potenti. Potenti consequat orci purus imperdiet bibendum lorem maecenas dapibus. Dapibus.","Sem potenti? Leo sollicitudin suscipit purus risus augue. Tempor, dolorem et luctus tellus.",2,3,"negative",22,21,4,8,6,9,7,"Market Value","Highlighted",4,4,3,4,0,-4,-3,-5,-4
"547",97,2,"Natoque? Sapien pretium ultricies dolorem magnis tempor. Culpa temporibus ab metus praesent.","Bibendum. Consequat iaculis cras sodales elit euismod fermentum facilisi accumsan purus fermentum ridiculus.",6,4,"negative",22,22,7,6,3,8,5.33333333333333,"Market Value","Highlighted",6,7,4,8,-1,1,1,0,0.5
"548",8,2,"Tempus cras! Felis luctus mi vestibulum nulla, at fermentum vitae.","Neque molestie dapibus ut a bibendum phasellus maecenas maecenas pretium.",1,7,"negative",21,22,3,9,2,4,4.33333333333333,"Market Value","Highlighted",1,9,5,5,-2,0,3,1,2
"549",96,1,"Wisi nonummy? Turpis fermentum felis pretium blandit lectus etiam dapibus vitae sit wisi. Lorem.","Ac. Dolorem vitae maecenas euismod mattis volutpat amet dolorem ab duis phasellus ab.",5,6,"negative",21,22,9,6,8,2,4.33333333333333,"Market Value","Highlighted",4,3,7,6,-5,-3,-1,4,1.5
"550",59,3,"Turpis diam venenatis euismod? Vitae lectus auctor scelerisque non consequat non.","Eget sed mi! Dolorem ante ac! Arcu felis duis praesent placerat nonummy.",1,2,"negative",22,22,4,2,1,4,7,"Market Value","Highlighted",8,1,4,8,4,-1,3,4,3.5
"551",99,1,"Vehicula dignissim accumsan pellentesque, ipsum euismod? Sapien, dolorem tellus fermentum nunc. Vitae.","Tortor nonummy duis sapien quis aliquam vulputate, massa! Pellentesque? Tempora.",6,6,"negative",21,22,1,4,4,8,4,"Market Value","Highlighted",2,5,6,9,1,1,2,1,1.5
"552",84,3,"Per. Praesent cursus magna curabitur maecenas? Blandit odio temporibus potenti. Malesuada. Orci sem consectetuer.","Consequat? Tincidunt tempus phasellus risus diam venenatis. Mattis porta faucibus pede faucibus euismod? Etiam rutrum.",1,7,"negative",21,22,6,5,5,9,7.66666666666667,"Market Value","Highlighted",5,7,2,3,-1,2,-3,-6,-4.5
"553",98,3,"Lacus! Auctor ligula magna? Metus dolor pretium dolorem consequat interdum consectetuer.","Quam magnis dolorem in luctus, lorem wisi porttitor culpa integer! Vestibulum id ridiculus vulputate? Bibendum.",2,3,"negative",22,21,7,2,2,1,6,"Market Value","Highlighted",8,1,8,1,1,-1,6,0,3
"554",88,3,"Neque aenean ante tincidunt fringilla bibendum interdum viverra. Tortor sit amet magnis gravida pede.","Duis nonummy molestie, ullamcorper, risus culpa scelerisque nonummy dictumst eros wisi curabitur cras cras.",6,2,"negative",22,22,5,3,3,5,5,"Market Value","Highlighted",9,3,4,7,4,0,1,2,1.5
"555",57,4,"Praesent! Donec purus viverra fringilla viverra a mauris per sed nec.","Tortor quam. Primis. Fermentum malesuada. Sagittis ligula. Amet massa? Wisi eget eros facilisi primis.",6,3,"negative",21,21,2,7,5,1,2,"Market Value","Highlighted",7,5,9,1,5,-2,4,0,2
"556",100,4,"Justo mauris commodo leo vestibulum neque felis? Ipsum! Duis dignissim cras.","Eu magnis volutpat etiam? Suscipit fusce turpis velit ridiculus odio arcu, euismod! Nulla.",3,2,"negative",21,22,1,9,1,3,4.33333333333333,"Market Value","Highlighted",5,6,9,4,4,-3,8,1,4.5
"557",86,2,"Facilisis ac! Gravida ligula volutpat viverra. Risus odio pretium sem? Metus felis! Aliquet. Cursus. Fusce.","Vulputate lacus wisi mattis dolor tellus vulputate montes ut porta velit id urna.",1,6,"negative",21,21,6,5,1,3,6,"Market Value","Highlighted",6,9,7,7,0,4,6,4,5
"558",7,4,"Duis enim mauris pharetra. Elit pede cras consectetuer nonummy. Mauris justo mauris mauris ullamcorper duis.","Est vivamus duis dolorem malesuada id. Maecenas sollicitudin vestibulum nibh. Auctor lorem pede.",5,4,"negative",21,21,4,8,2,4,1.66666666666667,"Market Value","Highlighted",7,4,8,3,3,-4,6,-1,2.5
"559",97,1,"Nunc augue non mi lorem vulputate velit vivamus! Sed consequat.","Sollicitudin cursus laoreet nunc? Dictumst mauris tempus auctor egestas faucibus tempora. Nunc.",2,5,"negative",22,21,7,6,4,5,4,"Market Value","Highlighted",2,6,2,7,-5,0,-2,2,0
"560",33,1,"Faucibus. Eget laoreet dictumst? Imperdiet tempor ac pharetra placerat ligula sagittis mattis. Pharetra pretium.","Placerat sollicitudin eleifend arcu convallis pede ultrices elementum. Etiam? A metus.",6,3,"negative",22,22,1,3,5,8,2.33333333333333,"Market Value","Highlighted",5,7,7,1,4,4,2,-7,-2.5
"561",5,1,"Donec laoreet interdum fermentum pede nulla platea etiam etiam laoreet gravida non lectus montes orci.","Diam est lorem sodales sed faucibus velit scelerisque leo quam etiam nullam.",4,7,"negative",22,21,6,1,4,8,7,"Market Value","Decreased",4,6,5,4,-2,5,1,-4,-1.5
"562",84,4,"Consequat praesent ante mi praesent nunc dapibus porttitor. Risus proin dolorem platea ligula interdum.","Molestie magna ipsum massa lorem porttitor etiam velit urna ab. Felis curabitur odio sed.",2,6,"negative",22,21,7,3,3,6,3,"Market Value","Decreased",1,4,3,2,-6,1,0,-4,-2
"563",96,4,"Velit, ultrices tempor per sed duis massa sodales ridiculus suspendisse.","Tellus mattis quis arcu? Facilisis atque ut odio. Sapien enim laoreet nullam nibh luctus tortor.",2,7,"negative",21,21,5,2,8,9,6.66666666666667,"Market Value","Decreased",9,4,7,9,4,2,-1,0,-0.5
"564",31,2,"Curabitur sodales turpis elit dictumst. Magnis dolorem placerat cursus ab! Cursus! Augue lectus gravida! Leo.","Morbi donec fermentum! Augue. Nec nec facilisi vulputate! Etiam justo vivamus et convallis urna.",1,4,"negative",22,21,5,3,3,5,6.33333333333333,"Market Value","Decreased",6,2,6,5,1,-1,3,0,1.5
"565",85,4,"Blandit dapibus, luctus mauris praesent. Arcu rhoncus dui magna vestibulum dictumst.","Leo vivamus ultrices! Eget eget eget felis? Bibendum pellentesque? Tempor fusce arcu montes.",1,3,"negative",22,22,1,2,2,9,5.33333333333333,"Market Value","Decreased",8,4,7,3,7,2,5,-6,-0.5
"566",34,3,"Dolorem nonummy, dignissim ridiculus luctus accusamus, convallis fringilla arcu! Pede odio consequat! Malesuada bibendum ultrices.","Pretium interdum eu? Tempor non, eros vivamus convallis, ut lacus fringilla.",2,5,"negative",22,22,8,8,2,1,7.66666666666667,"Market Value","Decreased",5,1,8,8,-3,-7,6,7,6.5
"567",67,1,"Turpis quis ipsum mattis nunc orci! Et aliquet! Ridiculus. Consequat.","Mauris dapibus cursus. Praesent! Commodo orci maecenas dolorem orci. Fusce euismod ac! Duis.",3,1,"negative",21,22,2,7,4,9,6,"Market Value","Decreased",3,7,9,2,1,0,5,-7,-1
"568",44,2,"Temporibus vivamus tellus interdum etiam ultricies. Culpa vestibulum eu odio, eget! Cursus ab.","Rutrum facilisis tempora eget volutpat pharetra imperdiet a vivamus dictumst potenti vulputate primis tellus etiam.",1,2,"negative",22,22,1,7,4,4,2.33333333333333,"Market Value","Decreased",7,8,9,3,6,1,5,-1,2
"569",75,3,"Nunc. Donec? Sollicitudin quam. Erat non gravida rutrum gravida! Accusamus porttitor turpis.","Ullamcorper! Tortor a tempor. Tortor potenti risus atque id aenean dapibus.",1,4,"negative",21,22,4,6,2,5,4.33333333333333,"Market Value","Decreased",9,8,4,1,5,2,2,-4,-1
"570",96,3,"Leo natoque nonummy aenean? Enim aenean, potenti risus nec magnis.","Ligula nunc aliquam vitae, vivamus. Commodo ligula consequat, nullam, mi consectetuer fringilla pharetra ligula.",5,7,"negative",22,22,2,6,8,1,6.66666666666667,"Market Value","Decreased",3,4,6,4,1,-2,-2,3,0.5
"571",16,2,"Purus. Sem. Laoreet? Vitae nullam aliquam lectus faucibus rhoncus. Suscipit suspendisse.","Molestie consectetuer pede ullamcorper? Dolorem cursus erat nulla luctus. Tempor dignissim.",5,1,"negative",22,21,9,3,9,7,7,"Market Value","Decreased",5,1,1,8,-4,-2,-8,1,-3.5
"572",80,4,"Eu per ab tempus. Dolor donec viverra, fermentum ac lorem, tempor neque eros leo.","Quis tellus, tempor mauris montes id temporibus! Consequat? Facilisis diam sit vel ante.",5,7,"negative",21,21,2,6,1,9,5.33333333333333,"Market Value","Decreased",6,4,5,1,4,-2,4,-8,-2
"573",77,2,"Suscipit donec vitae sed facilisi? Ultrices nullam curabitur! Etiam ante erat culpa, venenatis.","Pellentesque diam orci, metus? Odio, est magna atque. Eu vel duis porttitor iaculis.",2,1,"negative",22,21,5,1,1,8,3.66666666666667,"Market Value","Decreased",5,8,7,1,0,7,6,-7,-0.5
"574",15,1,"Ligula vivamus tellus dolor tempora. Ullamcorper potenti! Quis sollicitudin lorem nulla.","Platea sed magna porta ante vehicula aenean. Orci. Pharetra elementum eget, donec ante. Lacus.",1,4,"negative",21,21,6,9,1,8,4.66666666666667,"Market Value","Decreased",9,6,9,7,3,-3,8,-1,3.5
"575",86,4,"Nibh et magnis a phasellus lectus! Leo, vulputate natoque, tincidunt culpa. Volutpat proin sem est.","Eget nullam egestas eu nibh ultrices et integer fringilla primis.",5,3,"negative",21,22,8,2,4,8,3.33333333333333,"Market Value","Decreased",9,3,3,2,1,1,-1,-6,-3.5
"576",72,4,"In luctus. In pede sollicitudin non. Vulputate culpa sed sed massa fermentum, justo.","Tempor bibendum turpis blandit nullam tempus, nonummy consectetuer vivamus purus fermentum! Tempor faucibus malesuada.",1,3,"negative",21,21,1,2,1,5,6.33333333333333,"Market Value","Decreased",7,2,2,7,6,0,1,2,1.5
"577",70,1,"Auctor vel fermentum sapien enim augue sodales? Vitae convallis neque temporibus justo scelerisque erat imperdiet.","Phasellus? Porttitor diam, venenatis pretium potenti eget. Consequat. Ac. Molestie tellus.",5,6,"negative",22,21,8,6,4,3,6,"Market Value","Decreased",2,2,1,7,-6,-4,-3,4,0.5
"578",54,2,"Nec donec facilisi ridiculus consectetuer, imperdiet elementum tempor tempora ab, montes non magna ridiculus.","Nunc ultricies. Ligula fringilla, blandit arcu, aliquet. Leo. Ultrices risus rutrum nec. Tempus.",1,2,"negative",21,21,5,7,3,3,3,"Market Value","Decreased",4,4,2,2,-1,-3,-1,-1,-1
"579",100,2,"Sagittis ac, tortor elementum risus est dignissim posuere sem. Eget. Curabitur id dolor. Scelerisque.","Risus tellus integer, a platea eros posuere faucibus, fringilla cursus ridiculus euismod ridiculus montes viverra.",1,3,"negative",22,21,3,9,4,9,4.66666666666667,"Market Value","Decreased",5,8,1,3,2,-1,-3,-6,-4.5
"580",87,3,"Aliquam? Bibendum massa, proin non ultricies suscipit viverra temporibus ut? Lacus.","Lorem. Luctus vivamus dolor, ac culpa id tempor mi urna ab per etiam gravida vulputate.",5,5,"negative",21,22,6,1,8,8,5.33333333333333,"Market Value","Decreased",2,6,4,9,-4,5,-4,1,-1.5
"581",2,4,"Integer non volutpat id? Enim tempor dignissim metus volutpat. Eu posuere tellus montes.","Suscipit. Tempor pharetra tincidunt pharetra atque nibh? Elementum eu per nec imperdiet atque amet odio.",4,6,"negative",21,21,1,7,8,2,7,"Market Value","Decreased",1,6,3,6,0,-1,-5,4,-0.5
"582",24,3,"Commodo volutpat, dignissim nec fusce nec. Platea risus fusce placerat cursus sollicitudin. Ullamcorper risus.","Volutpat. Phasellus amet elit, accusamus molestie auctor id vestibulum cras.",1,1,"negative",21,22,9,2,8,7,1.66666666666667,"Market Value","Decreased",9,5,6,6,0,3,-2,-1,-1.5
"583",94,3,"Rhoncus vestibulum eleifend, aliquam ultrices elit tempus orci tincidunt. Faucibus ultricies magna.","Dolorem duis elementum enim mauris. Aenean fusce. Vulputate lacus elementum malesuada platea! Proin ipsum? Pharetra.",5,7,"negative",22,21,3,3,7,9,5.66666666666667,"Market Value","Decreased",6,3,7,6,3,0,0,-3,-1.5
"584",67,4,"Cras erat euismod suscipit proin pharetra posuere. Ultricies wisi eu vestibulum.","Non eu consectetuer ultricies primis? Ridiculus porttitor dui vulputate ultrices, sed. Temporibus. Id.",4,4,"negative",22,22,3,7,2,5,5.66666666666667,"Market Value","Decreased",9,6,2,5,6,-1,0,0,0
"585",63,3,"Blandit. Gravida laoreet lectus. Commodo faucibus. Sagittis fermentum mattis. Mauris sagittis nulla erat.","Mattis tempor natoque leo! Sapien. Eget justo integer tortor sit pretium.",3,7,"negative",22,22,6,9,2,7,7.33333333333333,"Market Value","Decreased",8,1,4,3,2,-8,2,-4,-1
"586",12,3,"Eu blandit. At platea quam nec tempor augue urna montes accusamus ac tempus.","Maecenas interdum pellentesque velit odio orci dapibus vulputate arcu in! Est. Morbi scelerisque mattis.",6,6,"negative",21,21,7,6,8,5,2.33333333333333,"Market Value","Decreased",2,5,5,1,-5,-1,-3,-4,-3.5
"587",25,2,"Bibendum purus id. Dolorem, cursus velit fermentum nibh! Ullamcorper non lorem morbi.","Platea dolor consequat sodales? Auctor. Morbi, commodo dignissim luctus lacus ligula.",4,2,"negative",22,21,3,7,5,3,7.66666666666667,"Market Value","Decreased",4,7,5,9,1,0,0,6,3
"588",34,4,"Molestie amet? Pretium eros! Porttitor tellus! Metus duis! Scelerisque consequat ultrices.","Neque! Duis? Vestibulum eu! Morbi. Fusce pede nibh lectus dignissim? Tellus in platea est.",4,6,"negative",21,22,5,6,5,4,3,"Market Value","Decreased",6,4,1,1,1,-2,-4,-3,-3.5
"589",19,1,"Facilisis. Egestas turpis, blandit ultrices. Eget mauris sem nibh in.","Eget. Fusce velit sed curabitur integer blandit dictumst sollicitudin risus. Maecenas.",1,4,"negative",22,22,5,7,4,1,6.33333333333333,"Market Value","Decreased",8,4,6,7,3,-3,2,6,4
"590",69,1,"Consequat magna? Auctor maecenas ullamcorper. Phasellus? Proin massa vulputate rhoncus molestie convallis aliquet maecenas ut.","Sapien fermentum bibendum euismod. Lectus natoque vestibulum? Laoreet, imperdiet mauris temporibus quis, facilisis.",6,3,"negative",22,21,5,1,9,3,4.33333333333333,"Market Value","Decreased",5,1,2,1,0,0,-7,-2,-4.5
"591",38,2,"Dapibus suspendisse ligula fusce placerat euismod leo volutpat orci rhoncus commodo. Faucibus rutrum fusce lacus.","Velit cras. Montes consequat aenean pharetra, metus natoque lacus dapibus! Dolorem, placerat sit per ultricies.",5,5,"negative",22,22,2,8,4,1,7,"Market Value","Decreased",1,1,8,3,-1,-7,4,2,3
"592",21,2,"Eget tempora integer? Vivamus? Tincidunt id! Volutpat velit vel rhoncus aliquet fringilla lacus.","Cras cras pede! Morbi. Nunc. Est risus ultrices. Purus, nullam in.",6,6,"negative",22,22,8,2,3,8,6.66666666666667,"Market Value","Decreased",7,4,7,3,-1,2,4,-5,-0.5
"593",54,2,"Culpa magnis, magnis justo blandit pellentesque culpa mauris tincidunt proin eu.","Vel velit per iaculis mi nonummy interdum ac cursus facilisis euismod ligula dolor.",6,1,"negative",21,22,2,6,6,6,4,"Market Value","Decreased",4,2,5,6,2,-4,-1,0,-0.5
"594",84,1,"Metus. Sed pretium temporibus accusamus lacus lectus? Massa. Odio dolorem platea.","Massa. Dictumst! Sit. Ligula sed aliquet! Elit! Aliquam urna turpis. At cursus suspendisse.",6,1,"negative",22,21,4,1,4,5,2.66666666666667,"Market Value","Decreased",8,4,6,5,4,3,2,0,1
"595",55,1,"Posuere venenatis sollicitudin convallis? Primis! Potenti pellentesque pharetra id. Morbi pretium dapibus viverra justo porttitor.","Per, posuere odio a! Arcu! Aliquam tempus sagittis est est tempora, quis rhoncus blandit potenti.",4,5,"negative",22,22,7,6,2,2,5.66666666666667,"Market Value","Decreased",8,6,9,5,1,0,7,3,5
"596",53,1,"Phasellus urna. Elit sodales, tempus dolor pretium vitae. Phasellus platea primis? Nunc magnis.","Pretium integer, viverra pede proin natoque aliquet at facilisi vehicula temporibus. Sapien vulputate.",1,6,"negative",21,22,7,5,7,3,4.66666666666667,"Market Value","Decreased",1,1,6,8,-6,-4,-1,5,2
"597",6,1,"Eleifend ullamcorper fringilla tempus tincidunt lectus temporibus at euismod. Potenti. Purus suscipit tempora! Malesuada.","Justo nibh? Elementum nonummy non sagittis pede lectus metus, consequat luctus tempus elit. Maecenas.",2,1,"negative",22,21,4,5,6,7,6.66666666666667,"Market Value","Decreased",3,6,1,2,-1,1,-5,-5,-5
"598",91,1,"Consectetuer eros! Ligula elit euismod auctor risus? Lacus vivamus! Maecenas tellus.","Viverra porta sapien wisi phasellus? A non euismod dapibus magnis. Porta ligula morbi ligula rutrum.",6,4,"negative",21,21,3,2,4,8,5,"Market Value","Decreased",3,9,1,5,0,7,-3,-3,-3
"599",100,4,"Elit augue tempor eleifend elementum. Accumsan elit lacus sed venenatis nibh. Mi.","Bibendum dignissim eget mi est odio. Fringilla? Tempora. Posuere? Proin ullamcorper tincidunt nullam magna.",2,6,"negative",22,21,5,5,1,1,7.33333333333333,"Market Value","Decreased",2,5,7,7,-3,0,6,6,6
"600",57,1,"Bibendum molestie urna potenti dapibus aliquam neque non ipsum. Tortor! Sollicitudin.","Est fringilla atque. Viverra. Vulputate fringilla quis a euismod consequat, interdum non! Leo ab potenti.",5,7,"negative",22,21,2,8,6,8,5,"Market Value","Decreased",8,7,5,1,6,-1,-1,-7,-4
"601",50,1,"Turpis rhoncus quam dolor accusamus malesuada. Est orci pellentesque. Fringilla odio sit montes sapien.","Sem temporibus velit sed amet nullam? Purus ultricies fermentum dictumst.",3,3,"negative",22,22,3,5,4,5,7.66666666666667,"Market Value","Decreased",7,4,7,6,4,-1,3,1,2
"602",0,4,"Rhoncus dignissim euismod faucibus suspendisse. Tempor interdum consectetuer? Consectetuer aenean sit porta. Scelerisque.","Atque integer ante aliquam lorem ac pellentesque? Donec tincidunt temporibus tellus atque eleifend.",2,7,"negative",21,21,4,8,3,9,6.66666666666667,"Market Value","Decreased",3,6,7,6,-1,-2,4,-3,0.5
"603",49,1,"Erat at id pharetra facilisi ullamcorper proin elementum laoreet ut turpis.","Blandit quam, viverra nec turpis fringilla dignissim potenti molestie maecenas elementum enim montes tempus non.",6,6,"negative",21,21,5,3,5,3,8,"Market Value","Decreased",8,6,4,6,3,3,-1,3,1
"604",72,2,"Eu sodales a temporibus platea ultricies? Molestie risus, natoque quam justo sed.","Morbi morbi ligula ab praesent nunc phasellus. Posuere fusce, maecenas.",6,7,"negative",22,21,3,1,4,4,5,"Market Value","Decreased",5,5,3,1,2,4,-1,-3,-2
"605",11,4,"Vehicula et placerat quam. Lacus donec lectus atque id. Volutpat pede primis! Tempora.","Purus temporibus nulla porttitor imperdiet pretium tempora proin? Interdum scelerisque.",4,5,"negative",22,22,1,7,2,2,6.33333333333333,"Market Value","Decreased",4,5,5,9,3,-2,3,7,5
"606",42,2,"Mattis duis, ipsum aliquam turpis porta risus. In sit vitae! Rutrum volutpat non elementum commodo.","Duis tempora. Erat aliquam amet augue eget magna atque at vestibulum faucibus enim tempora dolor.",1,7,"negative",22,22,6,2,6,9,6,"Market Value","Decreased",5,3,5,7,-1,1,-1,-2,-1.5
"607",24,1,"Diam eros dolor curabitur mauris vivamus porttitor donec per? Nunc wisi quam.","Commodo duis facilisi molestie volutpat wisi est lectus tortor fringilla wisi. Lorem, pellentesque! Pellentesque a.",1,1,"negative",21,21,1,3,9,6,3.33333333333333,"Market Value","Decreased",1,5,2,1,0,2,-7,-5,-6
"608",38,3,"Gravida est commodo elit facilisis. Porta ac? Vehicula faucibus! Temporibus auctor. Atque.","Potenti id dolorem sit faucibus pellentesque orci proin tempor curabitur sagittis massa.",6,4,"negative",21,22,7,1,7,4,5.66666666666667,"Market Value","Decreased",6,9,9,1,-1,8,2,-3,-0.5
"609",46,3,"Natoque pretium convallis pellentesque elementum. Dolorem praesent? Cras montes a ridiculus leo platea! Tempora ridiculus.","Eget vel, dapibus ultricies ligula? Nibh elementum tortor luctus urna. Nec phasellus? Facilisis.",6,4,"negative",22,22,2,9,7,7,3.66666666666667,"Market Value","Decreased",5,2,7,8,3,-7,0,1,0.5
"610",68,4,"Etiam ullamcorper accusamus tempus imperdiet non facilisis porttitor proin faucibus, nibh maecenas metus lorem.","Rutrum ab nunc! Velit neque laoreet pretium felis sollicitudin. Justo. Praesent, accumsan vivamus.",4,2,"negative",21,21,8,1,1,5,8,"Market Value","Decreased",5,2,7,1,-3,1,6,-4,1
"611",60,2,"Risus sodales tortor culpa venenatis vivamus. Mauris eu. Dui nunc dignissim facilisis.","Est a consequat eget, leo? Suspendisse rhoncus scelerisque! Fringilla porttitor.",1,6,"negative",21,21,2,5,6,2,3,"Market Value","Decreased",8,7,8,7,6,2,2,5,3.5
"612",23,2,"Malesuada montes. Molestie tincidunt nibh viverra. Luctus porta erat elit donec donec gravida malesuada.","Volutpat vitae culpa? Purus sed quis dictumst purus potenti! Justo quis accumsan.",2,3,"negative",22,21,4,4,3,7,2.33333333333333,"Market Value","Decreased",5,2,4,5,1,-2,1,-2,-0.5
"613",48,4,"Laoreet ipsum id? Lectus consectetuer. Nibh at? Odio etiam turpis ultricies! Dignissim.","Vel. Quis nec fermentum nunc vivamus, enim ridiculus iaculis? Rutrum, lacus, volutpat.",5,7,"negative",21,22,7,5,5,5,6.66666666666667,"Market Value","Decreased",5,3,6,9,-2,-2,1,4,2.5
"614",99,4,"Sagittis ridiculus massa quis sit maecenas. Vehicula platea blandit risus. Fusce felis.","Posuere ante culpa mattis ligula erat a et sit. Primis tellus? Fusce? Vehicula.",2,6,"negative",22,22,7,3,8,3,5.33333333333333,"Market Value","Decreased",7,3,8,5,0,0,0,2,1
"615",77,3,"Nibh atque. Ullamcorper facilisi ultrices vestibulum platea ullamcorper ab. Urna.","Integer. Felis? Rutrum! Viverra neque egestas eget dapibus? Dolorem elit.",5,3,"negative",22,22,1,9,7,1,3.66666666666667,"Market Value","Decreased",4,8,4,4,3,-1,-3,3,0
"616",75,3,"Sit eros eu faucibus dolor id duis erat tempora purus eleifend lectus? Enim.","Leo elementum facilisi ligula dapibus ab temporibus nonummy vestibulum. Elementum vestibulum.",4,1,"negative",22,21,2,2,9,9,4,"Market Value","Decreased",3,4,9,9,1,2,0,0,0
"617",75,2,"Venenatis dictumst, vehicula eros nonummy id neque, nunc rutrum ultricies lacus.","Vel orci? Blandit curabitur lectus pede venenatis et. Iaculis. Potenti.",6,3,"negative",21,21,2,9,9,3,8,"Market Value","Decreased",5,8,5,5,3,-1,-4,2,-1
"618",80,3,"Risus tortor lacus vehicula nullam risus mattis? Tellus sodales ut nonummy malesuada scelerisque magna.","Accusamus! Purus urna suscipit posuere fusce ac urna, nonummy mi potenti phasellus at.",3,6,"negative",22,21,9,5,4,8,6.33333333333333,"Market Value","Decreased",2,6,6,1,-7,1,2,-7,-2.5
"619",54,3,"Nibh justo. Ultrices diam proin temporibus sapien! Volutpat amet nibh purus dolor id fringilla.","Vehicula aliquet tellus purus porttitor pretium vehicula vivamus vitae. Augue.",2,7,"negative",22,21,3,3,6,8,3.33333333333333,"Market Value","Decreased",6,9,2,8,3,6,-4,0,-2
"620",2,2,"Neque rhoncus. Urna magnis? Molestie platea urna ultrices mauris aliquet sit iaculis venenatis justo.","Suscipit ante culpa wisi nulla malesuada urna eros massa dolorem suscipit nulla primis magna.",6,2,"negative",22,21,1,8,7,3,3,"Market Value","Decreased",8,9,7,2,7,1,0,-1,-0.5
"621",13,4,"Metus erat sed accumsan sagittis ipsum morbi proin dolorem in ligula mauris.","Cursus. Sagittis faucibus fermentum, culpa venenatis venenatis cras nulla. Amet leo.",3,1,"negative",21,21,7,9,7,6,3.33333333333333,"Market Value","Decreased",2,1,5,7,-5,-8,-2,1,-0.5
"622",1,4,"Viverra? Gravida duis imperdiet suscipit diam? Integer amet orci vitae praesent platea.","Mauris convallis placerat eros tempus rutrum venenatis dictumst ante laoreet ipsum primis accumsan.",5,6,"negative",21,22,4,4,4,5,3.66666666666667,"Market Value","Decreased",2,7,6,8,-2,3,2,3,2.5
"623",17,3,"In dolor luctus quis eu nibh diam. Etiam ipsum, ligula! Leo atque gravida sagittis lacus.","Euismod tempor cras pellentesque sodales suspendisse montes odio integer. Arcu diam et! Pharetra! Euismod.",3,3,"negative",21,21,8,7,7,1,6.33333333333333,"Market Value","Decreased",2,5,4,9,-6,-2,-3,8,2.5
"624",15,4,"Ultrices vehicula ullamcorper. Blandit cras quis ullamcorper suscipit potenti tellus, culpa.","Facilisis dolorem montes potenti wisi dapibus primis bibendum luctus felis facilisi dictumst.",4,5,"negative",22,22,1,5,2,3,6.66666666666667,"Market Value","Decreased",7,2,3,8,6,-3,1,5,3
"625",66,4,"Bibendum malesuada aenean venenatis phasellus aenean auctor. Tempor! Ac magnis nunc.","Suspendisse dictumst gravida pede mattis, nulla iaculis, ab id quis facilisi consectetuer pellentesque.",6,3,"negative",22,21,8,6,8,1,4.66666666666667,"Market Value","Decreased",8,6,3,6,0,0,-5,5,0
"626",26,4,"Ultricies velit sed rhoncus ligula dictumst volutpat tortor eleifend pellentesque dui orci.","Sollicitudin purus porttitor pellentesque. Elit, blandit tincidunt cras suspendisse gravida potenti platea.",3,4,"negative",21,22,2,5,2,4,6.33333333333333,"Market Value","Decreased",4,8,9,3,2,3,7,-1,3
"627",77,2,"Morbi porttitor facilisi rutrum non vitae venenatis morbi at, nullam.","Vehicula id! Nibh! Tincidunt luctus orci pellentesque! Non est temporibus a volutpat.",3,2,"negative",21,21,2,8,4,7,8.33333333333333,"Market Value","Decreased",7,7,3,9,5,-1,-1,2,0.5
"628",1,1,"Tortor dolor praesent facilisi dui? Morbi lectus. Pretium, vivamus aliquet, nibh porta vestibulum pellentesque.","Wisi? At montes molestie pretium ab erat vel arcu scelerisque potenti ullamcorper viverra! Porttitor.",4,2,"negative",21,21,1,8,7,4,5.66666666666667,"Market Value","Decreased",4,6,8,5,3,-2,1,1,1
"629",27,2,"Nec ut dolorem praesent laoreet ultrices! Accusamus, maecenas etiam auctor fermentum primis magna.","Bibendum blandit laoreet auctor vestibulum suspendisse sit. Bibendum bibendum vulputate accumsan.",3,4,"negative",21,22,1,2,8,2,3.33333333333333,"Market Value","Decreased",9,2,7,6,8,0,-1,4,1.5
"630",60,4,"Maecenas rutrum suscipit augue eleifend augue culpa! Justo imperdiet. Lectus imperdiet! Culpa.","Ligula. Potenti? Dolor fringilla sapien molestie? Molestie faucibus wisi! Ipsum consequat natoque. Tempora.",6,4,"negative",22,21,1,4,8,1,5.33333333333333,"Market Value","Decreased",5,6,4,6,4,2,-4,5,0.5
"631",93,4,"Dictumst, quam volutpat? Fringilla pellentesque mauris pharetra. Risus erat ultricies! Sed eu! Montes.","Malesuada arcu. Ridiculus volutpat eleifend aenean est augue curabitur, id vitae lorem lectus nunc.",6,1,"negative",22,22,8,9,5,3,2,"Market Value","Decreased",8,3,8,1,0,-6,3,-2,0.5
"632",90,2,"Vitae? Potenti! Turpis suscipit odio. Metus interdum vivamus eget. Tempor.","Tempora. Amet erat iaculis porttitor ultrices sed a lectus ut! Platea turpis leo.",4,7,"negative",21,22,2,6,9,7,5,"Market Value","Decreased",6,4,4,6,4,-2,-5,-1,-3
"633",11,2,"Eros nec platea proin nec felis? Purus nonummy, purus laoreet at ante.","Pretium. Metus risus consequat? Integer duis. Fermentum eget! Nibh orci turpis at ipsum rhoncus fringilla.",6,6,"negative",22,22,4,9,2,7,5,"Market Value","Decreased",5,5,7,1,1,-4,5,-6,-0.5
"634",21,2,"Justo ullamcorper pretium egestas diam neque pellentesque, eleifend pellentesque tempor sodales. Fringilla? Praesent.","Vestibulum aenean? Pellentesque nonummy? Faucibus quis vivamus ligula faucibus et rhoncus.",4,4,"negative",21,21,7,8,3,3,4,"Market Value","Decreased",1,9,3,5,-6,1,0,2,1
"635",81,2,"Accusamus eget? Scelerisque facilisis. Pellentesque. Laoreet tempus ante dolor purus imperdiet.","Placerat magna est? Pellentesque. Praesent ultricies. Porta dolor praesent tempor non fusce.",6,2,"negative",22,21,8,5,1,6,4,"Market Value","Decreased",4,2,8,8,-4,-3,7,2,4.5
"636",52,3,"Bibendum gravida! Fermentum. A! Eget id. Proin tempora nulla maecenas. Id.","Laoreet suspendisse tellus. Laoreet massa sed sapien? Dui. Consequat montes.",3,1,"negative",22,21,8,3,2,1,4.33333333333333,"Market Value","Decreased",4,7,2,4,-4,4,0,3,1.5
"637",63,1,"Dolor. Quam fringilla facilisi, facilisis malesuada temporibus mi bibendum bibendum rutrum mi.","Pharetra ullamcorper vestibulum. Quam porttitor? Mattis! Ligula sodales sodales tempus. Cursus dui per luctus.",4,1,"negative",22,21,4,7,5,7,6,"Market Value","Decreased",6,3,8,6,2,-4,3,-1,1
"638",88,2,"Dolorem! Sapien. Erat, accumsan per vitae phasellus ac purus risus scelerisque pharetra. Id ultrices nonummy.","Ligula lectus porttitor cras eget nibh scelerisque mi! Wisi eu elementum dignissim, in elementum.",6,4,"negative",22,21,7,4,5,3,5,"Market Value","Decreased",1,2,4,2,-6,-2,-1,-1,-1
"639",93,3,"Fringilla! Nullam. Duis nec faucibus tempus. Egestas venenatis, ultricies ultricies amet ante convallis.","Euismod dolorem. Auctor mi velit venenatis duis mattis pharetra maecenas cursus. Eleifend, eleifend proin fermentum.",5,3,"negative",21,21,9,3,7,4,3.33333333333333,"Market Value","Decreased",2,8,9,2,-7,5,2,-2,0
"640",94,1,"Id, bibendum egestas! Dolorem eu accumsan. Ac tortor tempus nullam faucibus metus ullamcorper bibendum justo.","Vitae molestie. Tellus erat est tellus quis. Mi nec per at.",1,7,"negative",21,22,4,7,9,9,6,"Market Value","Decreased",9,5,9,4,5,-2,0,-5,-2.5
